اے جی جوش 	/poets/a-g-josh
عابدہ عروج 	/poets/aabida-urooj
آفاق صدیقی 	/poets/aafaque-siddiqui?lang=ur
آفتاب الدولہ لکھنوی قلق 	/poets/aaftaab-ud-daula-lakhnavi-qalaq?lang=ur
آفتاب رئیس پانی پتی 	/poets/aaftab-rais-panipati?lang=ur
آغا نثار 	/poets/aaga-nisaar?lang=ur
آغا اکبرآبادی 	/poets/aagha-akbarabadi?lang=ur
آل احمد سرور 	/poets/aal-e-ahmad-suroor?lang=ur
آل رضا رضا 	/poets/aal-e-raza-raza?lang=ur
آلوک شریواستو 	/poets/aalok-shrivastav?lang=ur
عامر سہیل 	/poets/aamir-suhail?lang=ur
آنند سروپ انجم 	/poets/aanand-saroop-anjum?lang=ur
آنس معین 	/poets/aanis-moin?lang=ur
عارف الدین عاجز 	/poets/aarifuddin-aajiz?lang=ur
آس فاطمی 	/poets/aas-fatmi?lang=ur
آشفتہ چنگیزی 	/poets/aashufta-changezi?lang=ur
عاصی فائقی 	/poets/aasi-faiqi?lang=ur
آسی غازی پوری 	/poets/aasi-ghazipuri?lang=ur
عاصی کرنالی 	/poets/aasi-karnali?lang=ur
آسی رام نگری 	/poets/aasi-ramnagri?lang=ur
آسی الدنی 	/poets/aasi-uldani?lang=ur
عاصم شہنواز شبلی 	/poets/aasim-shahnawaz-shibli?lang=ur
آسناتھ کنول 	/poets/aasnath-kanwal?lang=ur
عاطف کمال رانا 	/poets/aatif-kamal-rana?lang=ur
عاطف وحید یاسر 	/poets/aatif-waheed-yasir?lang=ur
آتش بہاولپوری 	/poets/aatish-bahawalpuri?lang=ur
آتش اندوری 	/poets/aatish-indori?lang=ur
اعظم خورشید 	/poets/aazam-khursheed?lang=ur
عازم کوہلی 	/poets/aazim-kohli?lang=ur
عباس علی خاں بیخود 	/poets/abbas-ali-khan-bekhud?lang=ur
عباس علوی 	/poets/abbas-alvi?lang=ur
عباس اطہر 	/poets/abbas-athar?lang=ur
عباس دانا 	/poets/abbas-dana?lang=ur
عباس کیفی 	/poets/abbas-kaifi?lang=ur
عباس قمر 	/poets/abbas-qamar?lang=ur
عباس رضوی 	/poets/abbas-rizvi?lang=ur
عباس تابش 	/poets/abbas-tabish?lang=ur
عبد الاحد ساز 	/poets/abdul-ahad-saaz?lang=ur
عبدالعلیم آسی 	/poets/abdul-aleem-aasi?lang=ur
عبدالعزیز فطرت 	/poets/abdul-aziz-fitrat?lang=ur
عبد العزیز خالد 	/poets/abdul-aziz-khalid?lang=ur
عبد الغفور نساخ 	/poets/abdul-ghafoor-nassakh?lang=ur
عبد الہادی وفا 	/poets/abdul-hadi-wafa?lang=ur
عبدالحفیظ ساحل قادری 	/poets/abdul-hafeez-sahil-qadri?lang=ur
عبد الحفیظ نعیمی 	/poets/abdul-hafiz-naeemi?lang=ur
عبدالحلیم شرر 	/poets/abdul-halim-sharar?lang=ur
عبدالحمید ساقی 	/poets/abdul-hameed-saqi?lang=ur
عبد الحمید 	/poets/abdul-hamid?lang=ur
عبد الحمید عدم 	/poets/abdul-hamid-adam?lang=ur
اے جی جوش 	/poets/a-g-josh?lang=ur
عابدہ عروج 	/poets/aabida-urooj?lang=ur
عادل رضا منصوری 	/poets/aadil-raza-mansoori?lang=ur
آفاق صدیقی 	/poets/aafaque-siddiqui?lang=ur
آفتاب الدولہ لکھنوی قلق 	/poets/aaftaab-ud-daula-lakhnavi-qalaq?lang=ur
آفتاب رئیس پانی پتی 	/poets/aaftab-rais-panipati?lang=ur
آغا نثار 	/poets/aaga-nisaar?lang=ur
آغا اکبرآبادی 	/poets/aagha-akbarabadi?lang=ur
آل احمد سرور 	/poets/aal-e-ahmad-suroor?lang=ur
آل رضا رضا 	/poets/aal-e-raza-raza?lang=ur
آلوک شریواستو 	/poets/aalok-shrivastav?lang=ur
عامر سہیل 	/poets/aamir-suhail?lang=ur
آنند سروپ انجم 	/poets/aanand-saroop-anjum?lang=ur
آنس معین 	/poets/aanis-moin?lang=ur
عارف الدین عاجز 	/poets/aarifuddin-aajiz?lang=ur
آس فاطمی 	/poets/aas-fatmi?lang=ur
آشفتہ چنگیزی 	/poets/aashufta-changezi?lang=ur
عاصی فائقی 	/poets/aasi-faiqi?lang=ur
آسی غازی پوری 	/poets/aasi-ghazipuri?lang=ur
عاصی کرنالی 	/poets/aasi-karnali?lang=ur
آسی رام نگری 	/poets/aasi-ramnagri?lang=ur
آسی الدنی 	/poets/aasi-uldani?lang=ur
عاصم شہنواز شبلی 	/poets/aasim-shahnawaz-shibli?lang=ur
آسناتھ کنول 	/poets/aasnath-kanwal?lang=ur
عاطف کمال رانا 	/poets/aatif-kamal-rana?lang=ur
عاطف وحید یاسر 	/poets/aatif-waheed-yasir?lang=ur
آتش بہاولپوری 	/poets/aatish-bahawalpuri?lang=ur
آتش اندوری 	/poets/aatish-indori?lang=ur
اعظم خورشید 	/poets/aazam-khursheed?lang=ur
عازم کوہلی 	/poets/aazim-kohli?lang=ur
عباس علی خاں بیخود 	/poets/abbas-ali-khan-bekhud?lang=ur
عباس علوی 	/poets/abbas-alvi?lang=ur
عباس اطہر 	/poets/abbas-athar?lang=ur
عباس دانا 	/poets/abbas-dana?lang=ur
عباس کیفی 	/poets/abbas-kaifi?lang=ur
عباس قمر 	/poets/abbas-qamar?lang=ur
عباس رضوی 	/poets/abbas-rizvi?lang=ur
عباس تابش 	/poets/abbas-tabish?lang=ur
عبد الاحد ساز 	/poets/abdul-ahad-saaz?lang=ur
عبدالعلیم آسی 	/poets/abdul-aleem-aasi?lang=ur
عبدالعزیز فطرت 	/poets/abdul-aziz-fitrat?lang=ur
عبد العزیز خالد 	/poets/abdul-aziz-khalid?lang=ur
عبد الغفور نساخ 	/poets/abdul-ghafoor-nassakh?lang=ur
عبد الہادی وفا 	/poets/abdul-hadi-wafa?lang=ur
عبدالحفیظ ساحل قادری 	/poets/abdul-hafeez-sahil-qadri?lang=ur
عبد الحفیظ نعیمی 	/poets/abdul-hafiz-naeemi?lang=ur
عبدالحلیم شرر 	/poets/abdul-halim-sharar?lang=ur
عبدالحمید ساقی 	/poets/abdul-hameed-saqi?lang=ur
عبد الحمید 	/poets/abdul-hamid?lang=ur
عبد الحمید عدم 	/poets/abdul-hamid-adam?lang=ur
عبدالمجید بھٹی 	/poets/abdul-majeed-bhatti?lang=ur
عبدالمجید حیرت 	/poets/abdul-majeed-hairat?lang=ur
عبدالمجید خاں مجید 	/poets/abdul-majeed-khan-majeed?lang=ur
عبد المجید سالک 	/poets/abdul-majeed-salik?lang=ur
عبد الملک سوز 	/poets/abdul-malik-soz?lang=ur
عبدالمنان صمدی 	/poets/abdul-mannan-samadi?lang=ur
عبدالمنان طرزی 	/poets/abdul-mannan-tarzi?lang=ur
عبدالمتین نیاز 	/poets/abdul-mateen-niyaz?lang=ur
عبدالقوی ضیا 	/poets/abdul-qavi-ziya?lang=ur
عبدالرحمان بزمی 	/poets/abdul-rahman-bazmi?lang=ur
عبدالرحمان احسان دہلوی 	/poets/abdul-rahman-ehsan-dehlvi?lang=ur
عبدالرحمان خان وصفی بہرائچی 	/poets/abdul-rahman-khan-wasfi-bahraichi?lang=ur
عبدالرحمان راسخ 	/poets/abdul-rahman-rasikh?lang=ur
عبد السلام 	/poets/abdul-salam?lang=ur
عبد الوہاب سخن 	/poets/abdul-wahab-sukhan?lang=ur
عبدالوہاب یکروؔ 	/poets/abdul-wahab-yakro?lang=ur
عبد اللہ جاوید 	/poets/abdullah-javed?lang=ur
عبد اللہ کمال 	/poets/abdullah-kamal?lang=ur
عبدالطیف شوق 	/poets/abdullateef-shauq?lang=ur
عبداللہ خاں مہر لکھنوی 	/poets/abdullla-khan-mehr-lakhnavi?lang=ur
عبد الرحیم نشتر 	/poets/abdur-rahim-nashtar?lang=ur
عبد الرشید 	/poets/abdur-rasheed?lang=ur
عبد الرؤف عروج 	/poets/abdur-rauf-urooj?lang=ur
عبدالرحمان مومن 	/poets/abdurrahman-momin?lang=ur
عبدالرحمان واصف 	/poets/abdurrahman-wasif?lang=ur
عبدالشکور آسی 	/poets/abdushshukoor-aasi?lang=ur
عبدالصمد تپشؔ 	/poets/abdussamad-tapish?lang=ur
ابھیشیک کمار امبر 	/poets/abhishek-kumar-amber?lang=ur
ابھیشیک شکلا 	/poets/abhishek-shukla?lang=ur
عابد اختر 	/poets/abid-akhtar?lang=ur
عابد عالمی 	/poets/abid-almi?lang=ur
عابد حشری 	/poets/abid-hashri?lang=ur
عابد کرہانی 	/poets/abid-karhani?lang=ur
عابد کاظمی 	/poets/abid-kazmi?lang=ur
عابد خورشید 	/poets/abid-khursheed?lang=ur
عابد ملک 	/poets/abid-malik?lang=ur
عابد مناوری 	/poets/abid-munavari?lang=ur
عابد نامی 	/poets/abid-nami?lang=ur
عابد صدیق 	/poets/abid-siddiq?lang=ur
عابد سیال 	/poets/abid-syal?lang=ur
عابد ودود 	/poets/abid-wadood?lang=ur
ابر احسنی گنوری 	/poets/abr-ahsani-ganauri?lang=ur
ابرار عابد 	/poets/abrar-abid?lang=ur
ابرار احمد 	/poets/abrar-ahmad?lang=ur
ابرار اعظمی 	/poets/abrar-azmi?lang=ur
ابرار حامد 	/poets/abrar-hamid?lang=ur
ابرار کرتپوری 	/poets/abrar-kiratpuri?lang=ur
ابرار شاہجہانپوری 	/poets/abrar-shahjahanpuri?lang=ur
ابرارالحسن 	/poets/abrarul-hasan?lang=ur
آبرو شاہ مبارک 	/poets/abroo-shah-mubarak?lang=ur
ابصار عبد العلی 	/poets/absar-abdul-ali?lang=ur
ابو بکر عباد 	/poets/abu-bakr-abbad?lang=ur
ابو محمد سحر 	/poets/abu-mohammad-sahar?lang=ur
ابو تراب 	/poets/abu-turab?lang=ur
ابوزاہد سید یحییٰ حسینی قدر 	/poets/abu-zahid-sayyad-yahya-husaini-qadr?lang=ur
ابو الحسنات حقی 	/poets/abul-hasanat-haqqi?lang=ur
ابو الکلام آزاد 	/poets/abul-kalam-azad?lang=ur
ابو المجاہد زاہد 	/poets/abul-mujahid-zahid?lang=ur
ادا جعفری 	/poets/ada-jafarey?lang=ur
ادیب خلوت 	/poets/adeeb-khalwat?lang=ur
ادیب سہارنپوری 	/poets/adeeb-saharanpuri?lang=ur
ادیب سہیل 	/poets/adeeb-suhail?lang=ur
عدیل زیدی 	/poets/adeel-zaidi?lang=ur
عدیم ہاشمی 	/poets/adeem-hashmi?lang=ur
عادل فریدی 	/poets/adil-faridi?lang=ur
عادل حیات 	/poets/adil-hayat?lang=ur
عادل منصوری 	/poets/adil-mansuri?lang=ur
عادل رشید 	/poets/adil-rasheed?lang=ur
آدتیہ پنت ناقد 	/poets/aditya-pant-naaqid?lang=ur
عفیف سراج 	/poets/afeef-siraj?lang=ur
افقر موہانی 	/poets/afkar-mohani?lang=ur
افروز عالم 	/poets/afroz-alam?lang=ur
افروز طالب 	/poets/afroz-talib?lang=ur
افسر الہ آبادی 	/poets/afsar-allahabadi?lang=ur
افسر آذری 	/poets/afsar-azri?lang=ur
افسر جمشید 	/poets/afsar-jamshed?lang=ur
افسر ماہ پوری 	/poets/afsar-mahpuri?lang=ur
افسر میرٹھی 	/poets/afsar-merathi?lang=ur
آفتاب احمد 	/poets/aftab-ahmad?lang=ur
آفتاب احمد شاہ 	/poets/aftab-ahmad-shah?lang=ur
آفتاب عارف 	/poets/aftab-arif?lang=ur
آفتاب حسین 	/poets/aftab-hussain?lang=ur
آفتاب اقبال شمیم 	/poets/aftab-iqbal-shamim?lang=ur
آفتاب شاہ عالم ثانی 	/poets/aftab-shah-alam-sani?lang=ur
آفتاب شکیل 	/poets/aftab-shakeel?lang=ur
آفتاب شمسی 	/poets/aftab-shamsi?lang=ur
افضال فردوس 	/poets/afzaal-firdaus?lang=ur
افضال احمد سید 	/poets/afzal-ahmad-syed?lang=ur
افضل الہ آبادی 	/poets/afzal-allahabadi?lang=ur
افضل علوی 	/poets/afzal-alvi?lang=ur
افضل گوہر راؤ 	/poets/afzal-gauhar-rao?lang=ur
افضل ہزاروی 	/poets/afzal-hazarvi?lang=ur
افضل خان 	/poets/afzal-khan?lang=ur
افضل منہاس 	/poets/afzal-minhas?lang=ur
افضال نوید 	/poets/afzal-naved?lang=ur
افضل پرویز 	/poets/afzal-parvez?lang=ur
افضل پیشاوری 	/poets/afzal-peshawari?lang=ur
آغا حجو شرف 	/poets/agha-hajju-sharaf?lang=ur
آغا حشر کاشمیری 	/poets/agha-hashr-kashmiri?lang=ur
آغا محمد تقی خان ترقی 	/poets/agha-mohammad-taqi-khan-taraqqi?lang=ur
آغا شاعر قزلباش 	/poets/agha-shayar-qazalbash?lang=ur
آغا شاعر 	/poets/aghaa-shair?lang=ur
آغاز برنی 	/poets/aghaz-barni?lang=ur
آغاز بلڈانوی 	/poets/aghaz-buldhanwi?lang=ur
احمد علی برقی اعظمی 	/poets/ahmad-ali-barqi-azmi?lang=ur
احمد علوی 	/poets/ahmad-alvi?lang=ur
احمد اشفاق 	/poets/ahmad-ashfaq?lang=ur
احمد عطا 	/poets/ahmad-ata?lang=ur
احمد آزاد  	/poets/ahmad-azad?lang=ur
احمد عظیم 	/poets/ahmad-azeem?lang=ur
احمد عظیم آبادی 	/poets/ahmad-azimabadi?lang=ur
احمد فاخر 	/poets/ahmad-fakhir?lang=ur
احمد فقیہ 	/poets/ahmad-faqih?lang=ur
احمد فراز 	/poets/ahmad-faraz?lang=ur
احمد فرید 	/poets/ahmad-fareed?lang=ur
احمد فرہاد 	/poets/ahmad-farhad?lang=ur
احمد ہمدانی 	/poets/ahmad-hamdani?lang=ur
احمد ہمیش 	/poets/ahmad-hamesh?lang=ur
احمد حسین مائل 	/poets/ahmad-husain-mail?lang=ur
احمد حسین مجاہد 	/poets/ahmad-husain-mujahid?lang=ur
احمد جہانگیر 	/poets/ahmad-jahangeer?lang=ur
احمد جاوید 	/poets/ahmad-javed?lang=ur
احمد کمال حشمی 	/poets/ahmad-kamal-hashmi?lang=ur
احمد کمال پروازی 	/poets/ahmad-kamal-parwazi?lang=ur
احمد کامران 	/poets/ahmad-kamran?lang=ur
احمد خیال 	/poets/ahmad-khayal?lang=ur
احمد لطیف 	/poets/ahmad-lateef?lang=ur
احمد محفوظ 	/poets/ahmad-mahfuz?lang=ur
احمد معصوم 	/poets/ahmad-masoom?lang=ur
احمد مشتاق 	/poets/ahmad-mushtaq?lang=ur
احمد ندیم قاسمی 	/poets/ahmad-nadeem-qasmi?lang=ur
احمد راہی 	/poets/ahmad-rahi?lang=ur
احمد رضی بچھرایونی 	/poets/ahmad-razi-bachhrayuni?lang=ur
احمد ریاض 	/poets/ahmad-riyaz?lang=ur
احمد رضوان 	/poets/ahmad-rizwan?lang=ur
احمد صغیر صدیقی 	/poets/ahmad-sagheer-siddiqui?lang=ur
احمد سجاد بابر 	/poets/ahmad-sajjad-babar?lang=ur
احمد سلمان 	/poets/ahmad-salman?lang=ur
احمد شاہد خاں 	/poets/ahmad-shahid-khan?lang=ur
احمد شہریار 	/poets/ahmad-shahryar?lang=ur
احمد شناس 	/poets/ahmad-shanas?lang=ur
احمد سوز 	/poets/ahmad-soz?lang=ur
احمد تنویر 	/poets/ahmad-tanvir?lang=ur
احمد وحید اختر 	/poets/ahmad-waheed-akhtar?lang=ur
احمد وصی 	/poets/ahmad-wasi?lang=ur
احمد ظفر 	/poets/ahmad-zafar?lang=ur
احمد ضیا 	/poets/ahmad-ziya?lang=ur
احمق پھپھوندوی 	/poets/ahmaq-phaphoondvi?lang=ur
احمد عطاء اللہ 	/poets/ahmed-ataullah?lang=ur
احمد نثار 	/poets/ahmed-nisar?lang=ur
احمد شمیم 	/poets/ahmed-shamim?lang=ur
احسن احمد اشک 	/poets/ahsan-ahmad-ashk?lang=ur
احسن امام احسن 	/poets/ahsan-imam-ahsan?lang=ur
احسن لکھنوی 	/poets/ahsan-lakhnavi?lang=ur
احسن مارہروی 	/poets/ahsan-marahravi?lang=ur
احسن رضوی داناپوری 	/poets/ahsan-rizvi-danapuri?lang=ur
احسن سلیم 	/poets/ahsan-saleem?lang=ur
احسن شفیق 	/poets/ahsan-shafiq?lang=ur
احسن یوسف زئی 	/poets/ahsan-yusuf-zai?lang=ur
عین عرفان 	/poets/ain-irfan?lang=ur
عین رشید 	/poets/ain-rashid?lang=ur
عین سلام 	/poets/ain-salam?lang=ur
عین تابش 	/poets/ain-tabish?lang=ur
عین الدین عازم 	/poets/ainuddin-azim?lang=ur
عیش برنی 	/poets/aish-barni?lang=ur
عیش دہلوی 	/poets/aish-dehlvi?lang=ur
اجے سحاب 	/poets/ajay-sahaab?lang=ur
اجیت کمار دل 	/poets/ajeet-kumar-dil?lang=ur
اجیت سنگھ حسرت 	/poets/ajeet-singh-hasrat?lang=ur
عاجز کمال رانا  new	/poets/ajiz-kamaal-rana?lang=ur
عاجز ماتوی 	/poets/ajiz-matvi?lang=ur
اجمل اجملی 	/poets/ajmal-ajmali?lang=ur
اجمل صدیقی 	/poets/ajmal-siddiqi?lang=ur
اجمل سراج 	/poets/ajmal-siraj?lang=ur
اکبر علی خان عرشی زادہ 	/poets/akbar-ali-khan-arshi-zadah?lang=ur
اکبر الہ آبادی 	/poets/akbar-allahabadi?lang=ur
 اکبر حیدری 	/poets/akbar-haidri?lang=ur
اکبر حمیدی 	/poets/akbar-hameedi?lang=ur
اکبر حسین موہانی عبرت 	/poets/akbar-husain-mohani-ibrat?lang=ur
اکبر حیدرآبادی 	/poets/akbar-hyderabadi?lang=ur
اکبر کاظمی 	/poets/akbar-kazmi?lang=ur
اکبر معصوم 	/poets/akbar-masoom?lang=ur
اخگر مشتاق رحیم آبادی 	/poets/akhgar-mushtaq-raheem-aabadi?lang=ur
اکھلیش تیواری 	/poets/akhilesh-tiwari?lang=ur
اخلاق عاطف 	/poets/akhlaq-aatif?lang=ur
اخلاق احمد آہن 	/poets/akhlaq-ahmad-ahan?lang=ur
اخلاق بندوی 	/poets/akhlaque-bandvi?lang=ur
اختر علی اختر 	/poets/ali-akhtar-akhtar?lang=ur
اختر امان 	/poets/akhtar-amaan?lang=ur
اختر انصاری 	/poets/akhtar-ansari?lang=ur
اختر انصاری اکبرآبادی 	/poets/akhtar-ansari-akbarabadi?lang=ur
اختر آزاد 	/poets/akhtar-azad-1?lang=ur
اختر بستوی 	/poets/akhtar-bastavi?lang=ur
اختر فیروز 	/poets/akhtar-feroz?lang=ur
اختر ہاشمی 	/poets/akhtar-hashmi?lang=ur
اختر ہوشیارپوری 	/poets/akhtar-hoshiyarpuri?lang=ur
اختر حسین جعفری 	/poets/akhtar-husain-jafri?lang=ur
اختر امام رضوی 	/poets/akhtar-imam-rizvi?lang=ur
اختر لکھنوی 	/poets/akhtar-lakhnvi?lang=ur
اختر ملک 	/poets/akhtar-malik?lang=ur
اختر مسلمی 	/poets/akhtar-muslimi?lang=ur
اختر نظمی 	/poets/akhtar-nazmi?lang=ur
اختر اورینوی 	/poets/akhtar-orenvi?lang=ur
اختر پیامی 	/poets/akhtar-payami?lang=ur
اختر راہی 	/poets/akhtar-rahi?lang=ur
اختر رضا عدیل 	/poets/akhtar-raza-adeel?lang=ur
اختر رضا سلیمی 	/poets/akhtar-razaa-saleemi?lang=ur
اختر سعید 	/poets/akhtar-saeed?lang=ur
اختر سعید خان 	/poets/akhtar-saeed-khan?lang=ur
اختر سعیدی 	/poets/akhtar-saeedi?lang=ur
اختر شاہجہانپوری 	/poets/akhtar-shahjahanpuri?lang=ur
اختر شیخ 	/poets/akhtar-sheikh?lang=ur
اختر شیرانی 	/poets/akhtar-shirani?lang=ur
اختر شمار 	/poets/akhtar-shumar?lang=ur
اختر صدیقی 	/poets/akhtar-siddiqui?lang=ur
اختر عثمان 	/poets/akhtar-usman?lang=ur
اختر یوسف 	/poets/akhtar-yusuf?lang=ur
اختر ضیائی 	/poets/akhtar-ziai?lang=ur
اختر الایمان 	/poets/akhtar-ul-iman?lang=ur
اکمل امام 	/poets/akmal-imaam?lang=ur
اکرم محمود 	/poets/akram-mahmud?lang=ur
اکرم نقاش  	/poets/akram-naqqash?lang=ur
عکس سمستی پوری 	/poets/aks-samastipuri?lang=ur
عالم خورشید 	/poets/alam-khursheed?lang=ur
عالم مظفر نگری 	/poets/alam-muzaffar-nagari?lang=ur
عالم راحت 	/poets/alam-rahat?lang=ur
عالم تاب تشنہ 	/poets/alamtaab-tishna?lang=ur
علیم افسر 	/poets/aleem-afsar?lang=ur
علیم اختر 	/poets/aleem-akhtar?lang=ur
علیم درانی 	/poets/aleem-durrani?lang=ur
علیم مسرور 	/poets/aleem-masroor?lang=ur
علیم صبا نویدی 	/poets/aleem-saba-navedi?lang=ur
علیم عثمانی 	/poets/aleem-usmani?lang=ur
علینا عترت 	/poets/aleena-itrat?lang=ur
علی عباس امید 	/poets/ali-abbas-ummeed?lang=ur
علی احمد جلیلی 	/poets/ali-ahmad-jalili?lang=ur
علی اکبر عباس 	/poets/ali-akbar-abbas?lang=ur
علی اکبر منصور 	/poets/ali-akbar-mansoor?lang=ur
علی اکبر ناطق 	/poets/ali-akbar-natiq?lang=ur
علی ارمان 	/poets/ali-arman?lang=ur
علی اصغر 	/poets/ali-asghar?lang=ur
علی اصغر عباس 	/poets/ali-asghar-abbas?lang=ur
علی افتخار جعفری  	/poets/ali-iftikhar-jafri?lang=ur
علی عمران 	/poets/ali-imran?lang=ur
علی جواد زیدی 	/poets/ali-jawwad-zaidi?lang=ur
علی خان جوہر 	/poets/ali-khan-jauhar?lang=ur
علی منظور حیدرآبادی 	/poets/ali-manzoor-hyderabadi?lang=ur
علی محمد فرشی 	/poets/ali-mohammad-farshi?lang=ur
علی مطہر اشعر 	/poets/ali-muthar-ashar?lang=ur
علی مزمل 	/poets/ali-muzammil?lang=ur
علی ساحل 	/poets/ali-sahil?lang=ur
علی سردار جعفری 	/poets/ali-sardar-jafri?lang=ur
علی سرمد 	/poets/ali-sarmad?lang=ur
علی وجدان 	/poets/ali-wijdan?lang=ur
علی یاسر 	/poets/ali-yasir?lang=ur
علی ظہیر لکھنوی 	/poets/ali-zaheer-lakhnavi?lang=ur
علی زریون 	/poets/ali-zaryoun?lang=ur
علی زبیر 	/poets/ali-zubair?lang=ur
علیم اللہ 	/poets/alimullah?lang=ur
علیم اللہ حالی 	/poets/alimullah-hali?lang=ur
علی الدین نوید 	/poets/aliuddeen-naved?lang=ur
الکا مشرا 	/poets/alka-mishra?lang=ur
آل عمران 	/poets/all-imran?lang=ur
علامہ اقبال 	/poets/allama-iqbal?lang=ur
الماس شبی 	/poets/almas-shabi?lang=ur
آلوک مشرا 	/poets/alok-mishra?lang=ur
آلوک یادو 	/poets/alok-yadav?lang=ur
علقمہ شبلی 	/poets/alqama-shibli?lang=ur
الطاف احمد قریشی 	/poets/altaf-ahmad-qureshi?lang=ur
الطاف گوہر 	/poets/altaf-gauhar?lang=ur
الطاف حسین حالی 	/poets/altaf-hussain-hali?lang=ur
الطاف مشہدی 	/poets/altaf-mashhadi?lang=ur
الطاف پرواز 	/poets/altaf-parwaz?lang=ur
امانت لکھنوی 	/poets/amanat-lakhnavi?lang=ur
امان اللہ خالد 	/poets/amanullah-khalid?lang=ur
امر سنگھ فگار 	/poets/amar-singh-figar?lang=ur
عنبر بہرائچی 	/poets/ambar-bahraichi?lang=ur
عنبر کھربندہ 	/poets/ambar-kharbanda?lang=ur
عنبر شمیم 	/poets/ambar-shameem?lang=ur
عنبرین حسیب عنبر 	/poets/ambareen-haseeb-ambar?lang=ur
عنبرین صلاح الدین 	/poets/ambarin-salahuddin?lang=ur
امبر جوشی 	/poets/amber-joshi?lang=ur
عنبر وسیم الہآبادی 	/poets/amber-waseem-allahabadi?lang=ur
امین اڈیرائی 	/poets/ameen-adirai?lang=ur
امین حزیں 	/poets/ameen-hazin?lang=ur
امین راحت چغتائی 	/poets/ameen-rahat-chugtai?lang=ur
امین سلونی 	/poets/ameen-saloni?lang=ur
عمیق حنفی 	/poets/ameeq-hanafi?lang=ur
امیر احمد خسرو 	/poets/ameer-ahmad-khusro?lang=ur
امیراورنگ آبادی 	/poets/ameer-aurangabadi?lang=ur
امیر امام 	/poets/ameer-imam?lang=ur
امیر خسرو 	/poets/ameer-khusrau?lang=ur
امیر مینائی 	/poets/ameer-minai?lang=ur
امیر قزلباش 	/poets/ameer-qazalbash?lang=ur
'امیتا پرسو رام 'میتا 	/poets/ameeta-parsuram-meeta?lang=ur
عامر امیر 	/poets/amir-ameer?lang=ur
امیر حمزہ ثاقب 	/poets/amir-hamza-saqib?lang=ur
عامر موسوی 	/poets/amir-mausavi?lang=ur
عامر نظر 	/poets/amir-nazar?lang=ur
عامر ریاض 	/poets/amir-riyaz?lang=ur
عامر عثمانی 	/poets/amir-usmani?lang=ur
امیر اللہ تسلیم 	/poets/amirullah-tasleem?lang=ur
امت احد 	/poets/amit-ahad?lang=ur
امت برج شا 	/poets/amit-brij-sha?lang=ur
امت ستپال تنور  new	/poets/amit-satpal-tanwar?lang=ur
امت شرما میت 	/poets/amit-sharma-meet?lang=ur
امیتابھ بچن 	/poets/amitabh-bachchan?lang=ur
امجد حیدر آبادی 	/poets/amjad-hyderabadi-1?lang=ur
امجد اسلام امجد 	/poets/amjad-islam-amjad?lang=ur
امجد نجمی 	/poets/amjad-najmi?lang=ur
امجد شہزاد 	/poets/amjad-shahzad?lang=ur
عمار اقبال 	/poets/ammar-iqbal?lang=ur
امرت لال عشرت 	/poets/amrit-lal-ishrat?lang=ur
آنند نرائن ملا 	/poets/anand-narayan-mulla?lang=ur
عندلیب شادانی 	/poets/andaleeb-shadani?lang=ur
انیس احمد انیس 	/poets/anees-ahmad-anees?lang=ur
انیس انصاری 	/poets/anees-ansari?lang=ur
انیس اشفاق 	/poets/anees-ashfaq?lang=ur
انیس کیفی 	/poets/anees-kaifi?lang=ur
انیس ناگی 	/poets/anees-nagi?lang=ur
انیس ابر 	/poets/anis-abr?lang=ur
انیس دہلوی 	/poets/anis-dehlavi?lang=ur
انیسہ بیگم 	/poets/anisa-begum?lang=ur
انجنا سندھیر 	/poets/anjaana-sandhir?lang=ur
انجم عباسی 	/poets/anjum-abbasi?lang=ur
انجم انصاری 	/poets/anjum-ansari?lang=ur
انجم عظیم آبادی 	/poets/anjum-azimabadi?lang=ur
انجم اعظمی 	/poets/anjum-azmi?lang=ur
انجم بارہ بنکوی 	/poets/anjum-barabankvi?lang=ur
انجم فوقی بدایونی 	/poets/anjum-fauqi-badayuni?lang=ur
انجم عرفانی 	/poets/anjum-irfani?lang=ur
انجم خلیق 	/poets/anjum-khaleeq?lang=ur
انجم خیالی 	/poets/anjum-khayali?lang=ur
انجم لدھیانوی 	/poets/anjum-ludhianvi?lang=ur
انجم مانپوری 	/poets/anjum-manpuri?lang=ur
انجم نیازی 	/poets/anjum-niyazi?lang=ur
انجم رہبر 	/poets/anjum-rehbar?lang=ur
انجم رضوانی 	/poets/anjum-rizwani?lang=ur
انجم رومانی 	/poets/anjum-rumani?lang=ur
انجم سلیمی 	/poets/anjum-saleemi?lang=ur
انجم صدیقی 	/poets/anjum-siddiqui?lang=ur
انجم ترازی 	/poets/anjum-tarazi?lang=ur
انکت گوتم 	/poets/ankit-gautam?lang=ur
انکتا گرگ 	/poets/ankita-garg?lang=ur
انصر علی انصر 	/poets/ansar-ali-ansar?lang=ur
انو بھو گپتا 	/poets/anubhav-gupta?lang=ur
انور کیفی 	/poets/anvar-kaifi?lang=ur
انور محمود خالد 	/poets/anvar-mahmood-khalid?lang=ur
انور معظم 	/poets/anvar-moazzam?lang=ur
انور علیمی 	/poets/anwar-aleemi?lang=ur
انوار انجم 	/poets/anwar-anjum?lang=ur
انور بریلوی 	/poets/anwar-barelvi?lang=ur
انور دہلوی 	/poets/anwar-dehlvi?lang=ur
انوار فیروز 	/poets/anwar-feroz?lang=ur
انوار فطرت 	/poets/anwar-fitrat?lang=ur
انوار حبیب 	/poets/anwar-habeeb?lang=ur
انور جلال پوری 	/poets/anwar-jalalpuri?lang=ur
انور جمال انور 	/poets/anwar-jamal-anwar?lang=ur
انور خلیل 	/poets/anwar-khalil?lang=ur
انور خان 	/poets/anwar-khan-3?lang=ur
انور مقصود زاہدی 	/poets/anwar-maqsood-zahidi?lang=ur
انور مسعود 	/poets/anwar-masood?lang=ur
انور مینائی 	/poets/anwar-minai?lang=ur
انور مرزاپوری 	/poets/anwar-mirzapuri?lang=ur
انور ندیم 	/poets/anwar-nadim?lang=ur
انور صابری 	/poets/anwar-sabri?lang=ur
انور سدید 	/poets/anwar-sadeed?lang=ur
انور سہارنپوری 	/poets/anwar-saharanpuri?lang=ur
انور سین رائے 	/poets/anwar-sen-roy?lang=ur
انور شادانی 	/poets/anwar-shadani?lang=ur
انور شعور 	/poets/anwar-shuoor?lang=ur
انور صدیقی 	/poets/anwar-siddiqui?lang=ur
انور تاباں 	/poets/anwar-taban?lang=ur
انوری جہاں بیگم حجاب 	/poets/anwari-jahan-begum-hijab?lang=ur
انوار الحسن انوار 	/poets/anwarul-hasan-anwar?lang=ur
عقیل عباس 	/poets/aqeel-abbas?lang=ur
عقیل عباس جعفری 	/poets/aqeel-abbas-jafri?lang=ur
عقیل دانش 	/poets/aqeel-danish?lang=ur
عقیل جامد 	/poets/aqeel-jamid?lang=ur
عقیل نعمانی 	/poets/aqeel-nomani?lang=ur
عقیل شاداب 	/poets/aqeel-shadab?lang=ur
عاقب صابر 	/poets/aqib-sabir?lang=ur
ارادھنا پرساد 	/poets/aradhana-prasad?lang=ur
عارف عباس 	/poets/arif-abbas?lang=ur
عارف عباسی 	/poets/arif-abbasi?lang=ur
عارف عبدالمتین 	/poets/arif-abdul-mateen?lang=ur
عارف انصاری 	/poets/arif-ansari?lang=ur
عارف فرہاد 	/poets/arif-farhad?lang=ur
 عارف حسن  خان  	/poets/arif-hasan-khan?lang=ur
عارف امام 	/poets/arif-imam?lang=ur
عارف اشتیاق 	/poets/arif-ishtiaque?lang=ur
عارف شفیق 	/poets/arif-shafiq?lang=ur
عارفہ شہزاد 	/poets/arifa-shahzad?lang=ur
ارجمند بانو افشاں 	/poets/arjumand-bano-afshan?lang=ur
ارمان نجمی 	/poets/arman-najmi?lang=ur
ارپت شرما ارپت 	/poets/arpit-sharmaa-arpit?lang=ur
عرش ملسیانی 	/poets/arsh-malsiyani?lang=ur
عرش صہبائی 	/poets/arsh-sahbai?lang=ur
عرش صدیقی 	/poets/arsh-siddiqui?lang=ur
ارشد عبد الحمید 	/poets/arshad-abdul-hamid?lang=ur
ارشد علی خان قلق 	/poets/arshad-ali-khan-qalaq?lang=ur
ارشد جمال حشمی 	/poets/arshad-jamal-hashmi?lang=ur
ارشد جمال صارم 	/poets/arshad-jamal-sarim?lang=ur
ارشد کاکوی 	/poets/arshad-kakvi?lang=ur
ارشد کمال 	/poets/arshad-kamal?lang=ur
ارشد لطیف 	/poets/arshad-lateef?lang=ur
ارشد محمود ارشد 	/poets/arshad-mahmood-arshad?lang=ur
ارشد محمود ناشاد 	/poets/arshad-mahmood-nashad?lang=ur
ارشد ملک 	/poets/arshad-malik?lang=ur
ارشد معراج 	/poets/arshad-meraj?lang=ur
ارشد نعیم 	/poets/arshad-nayeem?lang=ur
ارشد صدیقی 	/poets/arshad-siddiqui?lang=ur
ارشد القادری 	/poets/arshadul-qadri?lang=ur
عرشی بھوپالی 	/poets/arshi-bhopali?lang=ur
عرشی رامپوری 	/poets/arshi-rampuri?lang=ur
ارون کمار آریہ 	/poets/arun-kumar-arya?lang=ur
آرزو لکھنوی 	/poets/arzoo-lakhnavi?lang=ur
آرزو سہارنپوری 	/poets/arzoo-saharanpuri?lang=ur
اسعد بدایونی 	/poets/asad-badayuni?lang=ur
اسد بھوپالی 	/poets/asad-bhopali?lang=ur
اسد جعفری 	/poets/asad-jafri?lang=ur
اسد ملتانی 	/poets/asad-multani?lang=ur
اسد رضا 	/poets/asad-raza?lang=ur
اثر اکبرآبادی 	/poets/asar-akbarabadi?lang=ur
اثر لکھنوی 	/poets/asar-lakhnavi?lang=ur
اثر رامپوری 	/poets/asar-rampuri?lang=ur
اثر صہبائی 	/poets/asar-sahbai?lang=ur
اسیر لکھنوی 	/poets/aseer-lakhnawi?lang=ur
اصغر عابد 	/poets/asghar-abid?lang=ur
اصغر گونڈوی 	/poets/asghar-gondvi?lang=ur
اصغر گورکھپوری 	/poets/asghar-gorakhpuri?lang=ur
اصغر مہدی ہوش 	/poets/asghar-mehdi-hosh?lang=ur
اصغر ندیم سید 	/poets/asghar-nadeem-sayed?lang=ur
اصغر راہی 	/poets/asghar-rahi?lang=ur
اصغر سلیم 	/poets/asghar-saleem?lang=ur
اصغر شمیم 	/poets/asghar-shamim?lang=ur
اصغر ویلوری 	/poets/asghar-velori?lang=ur
آشا پربھات 	/poets/asha-parbhat?lang=ur
اشہر ہاشمی 	/poets/ashar-hashmi?lang=ur
اشعر نجمی 	/poets/ashar-najmi?lang=ur
اشفاق عامر 	/poets/ashfaq-amir?lang=ur
اشفاق حسین 	/poets/ashfaq-husain?lang=ur
اشفاق ناصر 	/poets/ashfaq-nasir?lang=ur
اشفاق رشید منصوری 	/poets/ashfaq-rasheed-mansuri?lang=ur
اشفاق رہبر 	/poets/ashfaq-rehbar?lang=ur
اشفاق انجم 	/poets/ashfaque-anjum?lang=ur
اشہد بلال ابن چمن 	/poets/ashhad-bilal-ibn-e-chaman?lang=ur
عاشق اکبرآبادی 	/poets/ashique-akbarabadi?lang=ur
عاشر وکیل راؤ 	/poets/ashir-wakeel-rav?lang=ur
اشک امرتسری 	/poets/ashk-amritsari?lang=ur
اشک رامپوری 	/poets/ashk-rampuri?lang=ur
اشوک لال 	/poets/ashok-lal?lang=ur
اشوک مزاج بدر 	/poets/ashok-mizaj-badr?lang=ur
اشوک ساحل 	/poets/ashok-sahil?lang=ur
اشوک ساہنی 	/poets/ashok-sawhny?lang=ur
اشوک ساہنی ساحل 	/poets/ashok-sawhny-sahil?lang=ur
اشرف نقوی 	/poets/ashraf-naqvi?lang=ur
اشرف علی اشرف 	/poets/ashraf-ali-ashraf?lang=ur
اشرف علی فغاں 	/poets/ashraf-ali-fughan?lang=ur
اشرف جاوید 	/poets/ashraf-javed?lang=ur
اشرف رفیع 	/poets/ashraf-rafi?lang=ur
اشرف سلیم 	/poets/ashraf-saleem?lang=ur
اشرف شاد 	/poets/ashraf-shad?lang=ur
اشرف یوسف 	/poets/ashraf-yusuf?lang=ur
آشو مشرا 	/poets/ashu-mishra?lang=ur
آصف امان سیفی 	/poets/asif-aman-saifi?lang=ur
آصف انجم 	/poets/asif-anjum?lang=ur
آصف جمال 	/poets/asif-jamal?lang=ur
آصف رشید اسجد 	/poets/asif-rasheed-asjad?lang=ur
آصف رضا 	/poets/asif-raza?lang=ur
آصف ثاقب 	/poets/asif-saqib?lang=ur
آصف شفیع 	/poets/asif-shafi?lang=ur
آصفہ نشاط 	/poets/asifa-nishat?lang=ur
آصفہ زمانی 	/poets/asifa-zamani?lang=ur
آصف الدولہ 	/poets/asif-ud-daula?lang=ur
عاصمؔ واسطی 	/poets/asim-wasti?lang=ur
عاصمہ طاہر 	/poets/asima-tahir?lang=ur
اسلم انصاری 	/poets/aslam-ansari?lang=ur
اسلم آزاد 	/poets/aslam-azad?lang=ur
اسلم بدر 	/poets/aslam-badar?lang=ur
اسلم عمادی 	/poets/aslam-emadi?lang=ur
اسلم فیضی 	/poets/aslam-faizi?lang=ur
اسلم فرخی 	/poets/aslam-farrukhi?lang=ur
اسلم حبیب 	/poets/aslam-habeeb?lang=ur
اسلم حنیف 	/poets/aslam-haneef?lang=ur
اسلم کولسری 	/poets/aslam-kolsarii?lang=ur
اسلم محمود 	/poets/aslam-mahmood?lang=ur
اسلم راشد 	/poets/aslam-rashid?lang=ur
اسریٰ رضوی 	/poets/asra-rizvi?lang=ur
اسرار اکبر آبادی 	/poets/asrar-akbarabadi?lang=ur
اسرار جامعی 	/poets/asrar-jaamayee?lang=ur
اسرار زیدی 	/poets/asrar-zaidi?lang=ur
اسرارالحق اسرار 	/poets/asrarul-haq-asrar?lang=ur
اسرار الحق مجاز 	/poets/asrar-ul-haq-majaz?lang=ur
عطا عابدی 	/poets/ata-abidi?lang=ur
عطا حسین کلیم 	/poets/ata-husain-kaleem?lang=ur
عطا شاد 	/poets/ata-shad?lang=ur
عطا تراب 	/poets/ata-turab?lang=ur
عطاء الحق قاسمی 	/poets/ata-ul-haq-qasmi?lang=ur
اٹل بہاری واجپائی 	/poets/atal-bihari-vajpayee?lang=ur
عطاالحسن 	/poets/ataul-hasan?lang=ur
عطا الرحمن جمیل 	/poets/ataur-rahman-jameel?lang=ur
عطاالرحمٰن قاضی 	/poets/ataurrahman-qazi?lang=ur
عتیق احمد 	/poets/ateeq-ahmad-1?lang=ur
عتیق الہ آبادی 	/poets/ateeq-allahabadi?lang=ur
عتیق انظر 	/poets/ateeq-anzar?lang=ur
عتیق اثر 	/poets/ateeq-asar?lang=ur
عتیق مظفر پوری 	/poets/ateeq-muzaffarpuri?lang=ur
عطیہ داؤد 	/poets/ateeya-daud?lang=ur
عطیہ نیازی 	/poets/ateeya-niyazi?lang=ur
اطہر ادیب 	/poets/athar-adeeb?lang=ur
اطہر عزیز 	/poets/athar-aziz?lang=ur
اطہر نادر 	/poets/athar-nadir?lang=ur
اطہر نفیس 	/poets/athar-nafees?lang=ur
اطہر ناسک 	/poets/athar-nasik?lang=ur
اطہر راز 	/poets/athar-raz?lang=ur
اطہر سلیمی 	/poets/athar-saleemi?lang=ur
اطہر شکیل 	/poets/athar-shakeel?lang=ur
عاطف خان 	/poets/atif-khan?lang=ur
عتیق اللہ 	/poets/atiiqullah?lang=ur
عتیق الرحمٰن صفی 	/poets/atiq-ur-rehman-safi?lang=ur
اتل اجنبی 	/poets/atul-ajnabi?lang=ur
اطیب اعجاز 	/poets/atyab-ejaz?lang=ur
اوج لکھنوی 	/poets/auj-lakhnavi?lang=ur
اولاد علی رضوی 	/poets/aulad-ali-rizvi?lang=ur
اورنگ زیب 	/poets/aurang-zeb?lang=ur
ایاز احمد طالب 	/poets/ayaz-ahmad-talib?lang=ur
ایاز جھانسوی 	/poets/ayaz-jhansvi?lang=ur
ایاز محمود ایاز 	/poets/ayaz-mahmood-ayaz?lang=ur
ایاز رسول نازکی  new	/poets/ayaz-rasool-nazki?lang=ur
عائشہ مسعود ملک 	/poets/ayesha-masood-malik?lang=ur
ایوب جوہر 	/poets/ayub-jauhar?lang=ur
ایوب خاور 	/poets/ayub-khawar?lang=ur
ایوب رومانی 	/poets/ayub-rumani?lang=ur
ایوب صابر 	/poets/ayub-sabir?lang=ur
آیوش چراغ 	/poets/ayush-charag?lang=ur
آزاد انصاری 	/poets/azad-ansari?lang=ur
آزاد گلاٹی 	/poets/azad-gulati?lang=ur
آزاد گورداسپوری 	/poets/azad-gurdaspuri?lang=ur
آزاد حسین آزاد 	/poets/azad-husain-azad?lang=ur
اعظم چشتی 	/poets/azam-chishti?lang=ur
اعظم جلال آبادی 	/poets/azam-jalalabadi?lang=ur
آذر تمنا 	/poets/azar-tamanna?lang=ur
عظیم مرتضی 	/poets/azeem-murtaza?lang=ur
عظیم قریشی 	/poets/azeem-qureshi?lang=ur
عظیم الدین احمد 	/poets/azeemuddin-ahmad?lang=ur
عزیز پریہار 	/poets/azeez-prihar?lang=ur
اظہر عباس 	/poets/azhar-abbas?lang=ur
اظہر ادیب 	/poets/azhar-adeeb?lang=ur
اظہر علی 	/poets/azhar-ali?lang=ur
اظہر فراغ 	/poets/azhar-faragh?lang=ur
اظہر غوری 	/poets/azhar-ghauri?lang=ur
اظہر ہاشمی 	/poets/azhar-hashmi?lang=ur
اظہر عنایتی 	/poets/azhar-inayati?lang=ur
اظہر اقبال 	/poets/azhar-iqbal?lang=ur
اظہر جاوید 	/poets/azhar-javed?lang=ur
اظہر لکھنوی 	/poets/azhar-lakhnawi?lang=ur
اظہر نیر 	/poets/azhar-naiyyar?lang=ur
اظہرنقوی 	/poets/azhar-naqvi?lang=ur
اظہر نواز 	/poets/azhar-nawaz?lang=ur
اظہر قادری 	/authors/azhar-qadiri?lang=ur
اظہر سعید 	/poets/azhar-saeed?lang=ur
عظیم حیدر سید 	/poets/azim-haidar-syed?lang=ur
عزیز احمد 	/poets/aziz-ahmad?lang=ur
عزیز احمد خاں شفق 	/poets/aziz-ahmad-khan-shafaq?lang=ur
عزیز انصاری 	/poets/aziz-ansari?lang=ur
عزیز بدایونی 	/poets/aziz-badayuni?lang=ur
عزیز بانو داراب وفا 	/poets/aziz-bano-darab-wafa?lang=ur
عزیز اعجاز 	/poets/aziz-ejaz?lang=ur
عزیز فیصل 	/poets/aziz-faisal?lang=ur
عزیز حامد مدنی 	/poets/aziz-hamid-madni?lang=ur
عزیز حیدرآبادی 	/poets/aziz-hyderabadi?lang=ur
عزیز لکھنوی 	/poets/aziz-lakhnavi?lang=ur
عزیز نبیل 	/poets/aziz-nabeel?lang=ur
عزیز قیسی 	/poets/aziz-qaisi?lang=ur
عزیز صابری 	/poets/aziz-sabri?lang=ur
عزیز تمنائی 	/poets/aziz-tamannai?lang=ur
عزیز وارثی 	/poets/aziz-warsi?lang=ur
عزیز الرحمن شہید فتح پوری 	/poets/aziz-ur-rahman-shaheed-fatehpuri?lang=ur
ازلان شاہ 	/poets/azlan-shah?lang=ur
عزم بہزاد 	/poets/azm-bahzad?lang=ur
عزم شاکری 	/poets/azm-shakri?lang=ur
عظمت اللہ خاں 	/poets/azmatullah-khan?lang=ur
عذرا عباس 	/poets/azra-abbas?lang=ur
عذرا نقوی 	/poets/azra-naqvi?lang=ur
عذرا پروین 	/poets/azra-parveen?lang=ur
عذرا وحید 	/poets/azra-waheed?lang=ur
ازرق ادیم 	/poets/azraq-adeem?lang=ur
بی ایس جین جوہر 	/poets/b-s-jain-jauhar?lang=ur
بابر رحمان شاہ 	/poets/babar-rahman-shah?lang=ur
بدر جمالی 	/poets/badar-jamali?lang=ur
بدیع الزماں خاور 	/poets/badiuzzama-khawar?lang=ur
بدنام نظر 	/poets/badnam-nazar?lang=ur
بدر واسطی 	/poets/badr-wasti?lang=ur
بدر عالم خلش 	/poets/badr-e-alam-khalish?lang=ur
باغ حسین کمال 	/poets/bagh-husain-kamal?lang=ur
بہادر شاہ ظفر 	/poets/bahadur-shah-zafar?lang=ur
بہرام جی 	/poets/bahram-ji?lang=ur
بہرام طارق 	/poets/bahram-tariq?lang=ur
بخش لائلپوری 	/poets/bakhsh-layalpuri?lang=ur
بختیار ضیا 	/poets/bakhtiyar-ziya?lang=ur
بکل دیو 	/poets/bakul-dev?lang=ur
بلبیر راٹھی 	/poets/balbir-rathi?lang=ur
بلراج بخشی 	/poets/balraj-bakshi?lang=ur
بلراج حیات 	/poets/balraj-hayat?lang=ur
بلراج کومل 	/poets/balraj-komal?lang=ur
بلوان سنگھ آذر 	/poets/balwan-singh-azar?lang=ur
بانو بی 	/poets/bano-bee?lang=ur
بانو طاہرہ سعید 	/poets/bano-tahira-sayeed?lang=ur
بقا بلوچ 	/poets/baqa-baluch?lang=ur
باقر آگاہ ویلوری 	/poets/baqar-agah-vellori?lang=ur
باقر مہدی 	/poets/baqar-mehdi?lang=ur
باقر نقوی 	/poets/baqar-naqvi?lang=ur
بقا اللہ بقاؔ 	/poets/baqaullah-baqa?lang=ur
باقی احمد پوری 	/poets/baqi-ahmad-puri?lang=ur
باقی صدیقی 	/poets/baqi-siddiqui?lang=ur
برق دہلوی 	/poets/barq-dehlvi?lang=ur
برق حیدرآبادی 	/poets/barq-hyderabadi?lang=ur
بشر نواز 	/poets/bashar-nawaz?lang=ur
بشیر احمد بشیر 	/poets/basheer-ahmad-basheer?lang=ur
بشیر احمد شاد 	/poets/basheer-ahmad-shad?lang=ur
بشیر دادا 	/authors/basheer-dada?lang=ur
بشیر منذر 	/poets/basheer-munzir?lang=ur
بشیر الدین راز 	/poets/basheeruddin-raaz?lang=ur
بشیر النساء بیگم برق 	/poets/basheer-un-nisa-begum-barq?lang=ur
بشیر بدر 	/poets/bashir-badr?lang=ur
بشیر فاروق 	/poets/bashir-farooq?lang=ur
بشیر فاروقی 	/poets/bashir-farooqi?lang=ur
بشیر مہتاب 	/poets/bashir-mehtaab?lang=ur
بشیر سیفی 	/poets/bashir-saifi?lang=ur
بشیر زیدی اسیر 	/poets/bashir-zaidi-aseer?lang=ur
بشیر الدین احمد دہلوی 	/poets/bashiruddin-ahmad-dehlvi?lang=ur
باصر سلطان کاظمی 	/poets/basir-sultan-kazmi?lang=ur
باسط بھوپالی 	/poets/basit-bhopali?lang=ur
بیاں احسن اللہ خان 	/poets/bayan-ahsanullah-khan?lang=ur
بیان میرٹھی 	/poets/bayan-meeruti?lang=ur
بیان یزدانی 	/poets/bayan-yazdani?lang=ur
بیباک بھوجپوری 	/poets/bebak-bhojpuri?lang=ur
بی ایس جین جوہر 	/poets/b-s-jain-jauhar?lang=ur
بابر رحمان شاہ 	/poets/babar-rahman-shah?lang=ur
بدر جمالی 	/poets/badar-jamali?lang=ur
بدیع الزماں خاور 	/poets/badiuzzama-khawar?lang=ur
بدنام نظر 	/poets/badnam-nazar?lang=ur
بدر واسطی 	/poets/badr-wasti?lang=ur
بدر عالم خلش 	/poets/badr-e-alam-khalish?lang=ur
باغ حسین کمال 	/poets/bagh-husain-kamal?lang=ur
بہادر شاہ ظفر 	/poets/bahadur-shah-zafar?lang=ur
بہرام جی 	/poets/bahram-ji?lang=ur
بہرام طارق 	/poets/bahram-tariq?lang=ur
بخش لائلپوری 	/poets/bakhsh-layalpuri?lang=ur
بختیار ضیا 	/poets/bakhtiyar-ziya?lang=ur
بکل دیو 	/poets/bakul-dev?lang=ur
بلبیر راٹھی 	/poets/balbir-rathi?lang=ur
بلراج بخشی 	/poets/balraj-bakshi?lang=ur
بلراج حیات 	/poets/balraj-hayat?lang=ur
بلراج کومل 	/poets/balraj-komal?lang=ur
بلوان سنگھ آذر 	/poets/balwan-singh-azar?lang=ur
بانو بی 	/poets/bano-bee?lang=ur
بانو طاہرہ سعید 	/poets/bano-tahira-sayeed?lang=ur
بقا بلوچ 	/poets/baqa-baluch?lang=ur
باقر آگاہ ویلوری 	/poets/baqar-agah-vellori?lang=ur
باقر مہدی 	/poets/baqar-mehdi?lang=ur
باقر نقوی 	/poets/baqar-naqvi?lang=ur
بقا اللہ بقاؔ 	/poets/baqaullah-baqa?lang=ur
باقی احمد پوری 	/poets/baqi-ahmad-puri?lang=ur
باقی صدیقی 	/poets/baqi-siddiqui?lang=ur
برق دہلوی 	/poets/barq-dehlvi?lang=ur
برق حیدرآبادی 	/poets/barq-hyderabadi?lang=ur
بشر نواز 	/poets/bashar-nawaz?lang=ur
بشیر احمد بشیر 	/poets/basheer-ahmad-basheer?lang=ur
بشیر احمد شاد 	/poets/basheer-ahmad-shad?lang=ur
بشیر دادا 	/authors/basheer-dada?lang=ur
بشیر منذر 	/poets/basheer-munzir?lang=ur
بشیر الدین راز 	/poets/basheeruddin-raaz?lang=ur
بشیر النساء بیگم برق 	/poets/basheer-un-nisa-begum-barq?lang=ur
بشیر بدر 	/poets/bashir-badr?lang=ur
بشیر فاروق 	/poets/bashir-farooq?lang=ur
بشیر فاروقی 	/poets/bashir-farooqi?lang=ur
بشیر مہتاب 	/poets/bashir-mehtaab?lang=ur
بشیر سیفی 	/poets/bashir-saifi?lang=ur
بشیر زیدی اسیر 	/poets/bashir-zaidi-aseer?lang=ur
بشیر الدین احمد دہلوی 	/poets/bashiruddin-ahmad-dehlvi?lang=ur
باصر سلطان کاظمی 	/poets/basir-sultan-kazmi?lang=ur
باسط بھوپالی 	/poets/basit-bhopali?lang=ur
بیاں احسن اللہ خان 	/poets/bayan-ahsanullah-khan?lang=ur
بیان میرٹھی 	/poets/bayan-meeruti?lang=ur
بیان یزدانی 	/poets/bayan-yazdani?lang=ur
بیباک بھوجپوری 	/poets/bebak-bhojpuri?lang=ur
بیدم شاہ وارثی 	/poets/bedam-shah-warsi?lang=ur
بیدار سرمدی 	/poets/bedar-sarmadi?lang=ur
بیدل حیدری 	/poets/bedil-haidri?lang=ur
بینا گوئندی 	/poets/beena-goindi?lang=ur
بیگم لکھنوی 	/poets/begam-lakhnavi?lang=ur
بہزاد لکھنوی 	/poets/behzad-lakhnavi?lang=ur
بیکل اتساہی 	/poets/bekal-utsahi?lang=ur
بیخود بدایونی 	/poets/bekhud-badayuni?lang=ur
بیخود دہلوی 	/poets/bekhud-dehlvi?lang=ur
بیتاب عظیم آبادی 	/poets/betab-azimabadi?lang=ur
بیتاب لکھنوی 	/poets/betab-lakhnavi?lang=ur
بیتاب سوری 	/poets/betab-sury?lang=ur
بھارت بھوشن پنت 	/poets/bharat-bhushan-pant?lang=ur
بھارتیندو ہریش چندر 	/poets/bhartendu-harishchandra?lang=ur
بھاسکر شکلا 	/poets/bhaskar-shukla?lang=ur
بھویش دلشاد 	/poets/bhavesh-dilshad?lang=ur
بھورے خان آشفتہ 	/poets/bhure-khan-ashufta?lang=ur
بلال احمد 	/poets/bilal-ahmad?lang=ur
بلقیس خان 	/poets/bilqees-khan?lang=ur
بلقیس ظفیر الحسن 	/poets/bilqis-zafirul-hasan?lang=ur
بلقیس بیگم 	/poets/bilquis-begum?lang=ur
بمل کرشن اشک 	/poets/bimal-krishn-ashk?lang=ur
برج لال رعنا 	/poets/birj-lal-raana?lang=ur
بشن نرائن درابر 	/poets/bishan-narayen-darabar?lang=ur
بسمل آغائی 	/poets/bismil-aghai?lang=ur
بسمل الہ آبادی 	/poets/bismil-allahabadi?lang=ur
بسملؔ  عظیم آبادی 	/poets/bismil-azimabadi?lang=ur
بسمل صابری 	/poets/bismil-sabri?lang=ur
بسمل سعیدی 	/poets/bismil-saeedi?lang=ur
بوم میرٹھی 	/poets/boom-merathi?lang=ur
برہما نند جلیس 	/poets/brahma-nand-jalees?lang=ur
برجیش عنبر 	/poets/brijesh-ambar?lang=ur
ببلس ھورہ صبا 	/poets/bubbles-hora-saba-3?lang=ur
بدھ پرکاش گپتاجوہر دیوبندی 	/poets/budh-parkash-gupta-jauhar-deobandi?lang=ur
بشریٰ اعجاز 	/poets/bushra-ejaz?lang=ur
بشریٰ فرخ 	/poets/bushra-farrukh?lang=ur
بشریٰ ہاشمی 	/poets/bushra-hashmi?lang=ur
بشریٰ سعید 	/poets/bushra-saeed?lang=ur
بشری زیدی 	/poets/bushra-zaidi?lang=ur
چکبست برج نرائن 	/poets/chakbast-brij-narayan?lang=ur
چمن بھٹناگر 	/poets/chaman-bhatnagar?lang=ur
چمن لال چمن 	/poets/chaman-lal-chaman?lang=ur
چاند اکبرآبادی 	/poets/chand-akbarabadi?lang=ur
چندر بھان کیفی دہلوی 	/poets/chandar-bhan-kaifi-delhwi?lang=ur
چاندنی پانڈے 	/poets/chandni-pandey?lang=ur
چندر پرکاش جوہر بجنوری 	/poets/chandra-parkash-jauhar-bijnauri?lang=ur
چندر پرکاش شاد 	/poets/chandra-parkash-shad?lang=ur
چندر بھان خیال 	/poets/chandrabhan-khayal?lang=ur
چراغ بریلوی 	/poets/charagh-barelvi?lang=ur
چرن سنگھ بشر 	/poets/charan-singh-bashar?lang=ur
چرخ چنیوٹی 	/poets/charkh-chinioti?lang=ur
چودھری محمد نعیم 	/poets/chaudhary-mohammad-naeem?lang=ur
چراغ حسن حسرت 	/poets/chiragh-hasan-hasrat?lang=ur
چترانش کھرے 	/poets/chitransh-khare?lang=ur
چکبست برج نرائن 	/poets/chakbast-brij-narayan?lang=ur
چمن بھٹناگر 	/poets/chaman-bhatnagar?lang=ur
چمن لال چمن 	/poets/chaman-lal-chaman?lang=ur
چاند اکبرآبادی 	/poets/chand-akbarabadi?lang=ur
چندر بھان کیفی دہلوی 	/poets/chandar-bhan-kaifi-delhwi?lang=ur
چاندنی پانڈے 	/poets/chandni-pandey?lang=ur
چندر پرکاش جوہر بجنوری 	/poets/chandra-parkash-jauhar-bijnauri?lang=ur
چندر پرکاش شاد 	/poets/chandra-parkash-shad?lang=ur
چندر بھان خیال 	/poets/chandrabhan-khayal?lang=ur
چراغ بریلوی 	/poets/charagh-barelvi?lang=ur
چرن سنگھ بشر 	/poets/charan-singh-bashar?lang=ur
چرخ چنیوٹی 	/poets/charkh-chinioti?lang=ur
چودھری محمد نعیم 	/poets/chaudhary-mohammad-naeem?lang=ur
چراغ حسن حسرت 	/poets/chiragh-hasan-hasrat?lang=ur
چترانش کھرے 	/poets/chitransh-khare?lang=ur
ڈی ۔ راج کنول 	/poets/d-raj-kanwal?lang=ur
دائم غواصی 	/poets/daem-gawwasi?lang=ur
داغؔ دہلوی 	/poets/dagh-dehlvi?lang=ur
دامودر ٹھاکر ذکی 	/poets/damodar-thakur-zaki?lang=ur
دانشؔ علیگڑھی 	/poets/danish-aligarhi?lang=ur
دانش فراہی 	/poets/danish-farahi?lang=ur
دانش فرازی 	/poets/danish-farazi?lang=ur
دانش نذیر دانی 	/poets/danish-nazeer-dani?lang=ur
دانیال طریر 	/poets/daniyal-tareer?lang=ur
داؤد محسن 	/poets/daood-mohsin?lang=ur
درشن سنگھ 	/poets/darshan-singh?lang=ur
درشکا وسانی 	/poets/darshika-wasani?lang=ur
درویش بھارتی 	/poets/darvesh-bharti?lang=ur
دتا تریہ کیفی 	/poets/dattatriya-kaifi?lang=ur
داؤد اورنگ آبادی 	/poets/daud-aurangabadi?lang=ur
داؤد غازی 	/poets/daud-ghazi?lang=ur
دور آفریدی 	/poets/daur-afridi?lang=ur
دوارکا داس شعلہ 	/poets/davarka-das-shola?lang=ur
داؤد رضوان 	/poets/dawood-rizwan?lang=ur
دید راہی 	/poets/deed-rahi?lang=ur
دیپک قمر 	/poets/deepak-qamar?lang=ur
دیپک شرما دیپ 	/poets/deepak-sharma-deep?lang=ur
دپتی مشرا 	/poets/deepti-mishra?lang=ur
دویش دکشت 	/poets/devesh-dixit?lang=ur
دیومنی پانڈے 	/poets/devmani-pandey?lang=ur
دھنپت رائے تھاپر راز 	/poets/dhanpat-rai-thapar-raz?lang=ur
دھیریندر سنگھ فیاض 	/poets/dheerendra-singh-faiyaz?lang=ur
دل ایوبی  	/poets/dil-ayubi?lang=ur
دل شاہجہاں پوری 	/poets/dil-shahjahanpuri?lang=ur
دلاور علی آزر 	/poets/dilawar-ali-aazar?lang=ur
دلاور فگار 	/poets/dilawar-figar?lang=ur
دلدار ہاشمی 	/poets/dildar-hashmi?lang=ur
دلکش ساگری 	/poets/dilkash-sagari?lang=ur
دناکشی سحر 	/poets/dinakshi-sahar?lang=ur
دنیش کمار 	/poets/dinesh-kumar?lang=ur
دنیش نائیڈو 	/poets/dinesh-naaidu?lang=ur
دنیش ٹھاکر 	/poets/dinesh-thakur?lang=ur
دواکر راہی 	/poets/divakar-rahi?lang=ur
دوُیہ مہیشوری 	/poets/divya-maheshwari?lang=ur
ڈاکٹر اعظم 	/poets/dr-azam?lang=ur
ڈاکٹر محمد علی جوہر 	/poets/dr-mohammad-ali-johar?lang=ur
ڈاکٹر پنہاں 	/poets/dr-pinhaan?lang=ur
دشینتؔ کمار 	/poets/dushyant-kumar?lang=ur
دوجیندر دوج 	/poets/dwijendra-dwij?lang=ur
ڈی ۔ راج کنول 	/poets/d-raj-kanwal?lang=ur
دائم غواصی 	/poets/daem-gawwasi?lang=ur
داغؔ دہلوی 	/poets/dagh-dehlvi?lang=ur
دامودر ٹھاکر ذکی 	/poets/damodar-thakur-zaki?lang=ur
دانشؔ علیگڑھی 	/poets/danish-aligarhi?lang=ur
دانش فراہی 	/poets/danish-farahi?lang=ur
دانش فرازی 	/poets/danish-farazi?lang=ur
دانش نذیر دانی 	/poets/danish-nazeer-dani?lang=ur
دانیال طریر 	/poets/daniyal-tareer?lang=ur
داؤد محسن 	/poets/daood-mohsin?lang=ur
درشن سنگھ 	/poets/darshan-singh?lang=ur
درشکا وسانی 	/poets/darshika-wasani?lang=ur
درویش بھارتی 	/poets/darvesh-bharti?lang=ur
دتا تریہ کیفی 	/poets/dattatriya-kaifi?lang=ur
داؤد اورنگ آبادی 	/poets/daud-aurangabadi?lang=ur
داؤد غازی 	/poets/daud-ghazi?lang=ur
دور آفریدی 	/poets/daur-afridi?lang=ur
دوارکا داس شعلہ 	/poets/davarka-das-shola?lang=ur
داؤد رضوان 	/poets/dawood-rizwan?lang=ur
دید راہی 	/poets/deed-rahi?lang=ur
دیپک قمر 	/poets/deepak-qamar?lang=ur
دیپک شرما دیپ 	/poets/deepak-sharma-deep?lang=ur
دپتی مشرا 	/poets/deepti-mishra?lang=ur
دویش دکشت 	/poets/devesh-dixit?lang=ur
دیومنی پانڈے 	/poets/devmani-pandey?lang=ur
دھنپت رائے تھاپر راز 	/poets/dhanpat-rai-thapar-raz?lang=ur
دھیریندر سنگھ فیاض 	/poets/dheerendra-singh-faiyaz?lang=ur
دل ایوبی  	/poets/dil-ayubi?lang=ur
دل شاہجہاں پوری 	/poets/dil-shahjahanpuri?lang=ur
دلاور علی آزر 	/poets/dilawar-ali-aazar?lang=ur
دلاور فگار 	/poets/dilawar-figar?lang=ur
دلدار ہاشمی 	/poets/dildar-hashmi?lang=ur
دلکش ساگری 	/poets/dilkash-sagari?lang=ur
دناکشی سحر 	/poets/dinakshi-sahar?lang=ur
دنیش کمار 	/poets/dinesh-kumar?lang=ur
دنیش نائیڈو 	/poets/dinesh-naaidu?lang=ur
دنیش ٹھاکر 	/poets/dinesh-thakur?lang=ur
دواکر راہی 	/poets/divakar-rahi?lang=ur
دوُیہ مہیشوری 	/poets/divya-maheshwari?lang=ur
ڈاکٹر اعظم 	/poets/dr-azam?lang=ur
ڈاکٹر محمد علی جوہر 	/poets/dr-mohammad-ali-johar?lang=ur
ڈاکٹر پنہاں 	/poets/dr-pinhaan?lang=ur
دشینتؔ کمار 	/poets/dushyant-kumar?lang=ur
دوجیندر دوج 	/poets/dwijendra-dwij?lang=ur
احسان اکبر 	/poets/ehsan-akbar?lang=ur
احسن علی خاں 	/poets/ehsan-ali-khan?lang=ur
احسان اصغر 	/poets/ehsan-asghar?lang=ur
احسان دانش 	/poets/ehsan-danish?lang=ur
احسان دربھنگوی 	/poets/ehsan-darbhangavi?lang=ur
احسان جعفری 	/poets/ehsan-jafri?lang=ur
احسان ثاقب 	/poets/ehsan-saqib?lang=ur
احترام اسلام 	/poets/ehteram-islam?lang=ur
اہتمام صادق 	/poets/ehtimam-sadiq?lang=ur
احتشام اختر 	/poets/ehtisham-akhtar?lang=ur
احتشام حسین 	/poets/ehtisham-husain?lang=ur
احتشام الحق صدیقی 	/poets/ehtisham-ul-haq-siddiqui?lang=ur
احیا بھوجپوری 	/poets/ehya-bhojpuri?lang=ur
اعجاز احمد اعجاز 	/poets/ejaaz-ahamd-ejaaz?lang=ur
اعجاز طالب 	/poets/ejaaz-talib?lang=ur
اعجاز توکل 	/poets/ejaaz-tawakkal?lang=ur
اعجاز آصف 	/poets/ejaz-asif?lang=ur
اعجاز اعظمی 	/poets/ejaz-azmi?lang=ur
اعجاز فاروقی 	/poets/ejaz-farooqi?lang=ur
اعجاز گل 	/poets/ejaz-gul?lang=ur
اعجاز عبید 	/poets/ejaz-obaid?lang=ur
اعجاز راہی 	/poets/ejaz-rahi?lang=ur
اعجاز رحمانی 	/poets/ejaz-rahmani?lang=ur
اعجاز رضوی 	/poets/ejaz-rizvi?lang=ur
اعجاز صدیقی 	/poets/ejaz-siddiqi?lang=ur
اعجاز وارثی 	/poets/ejaz-warsi?lang=ur
ایلزبتھ کورین مونا 	/poets/elizabeth-kurian-mona?lang=ur
ارم زہرا 	/poets/erum-zehra?lang=ur
اعتبار ساجد 	/poets/etibar-sajid?lang=ur
اعزاز افصل 	/poets/ezaz-afzal?lang=ur
اعزاز احمد آذر 	/poets/ezaz-ahmad-azar?lang=ur
اعزاز کاظمی 	/poets/ezaz-kazmi?lang=ur
احسان اکبر 	/poets/ehsan-akbar?lang=ur
احسن علی خاں 	/poets/ehsan-ali-khan?lang=ur
احسان اصغر 	/poets/ehsan-asghar?lang=ur
احسان دانش 	/poets/ehsan-danish?lang=ur
احسان دربھنگوی 	/poets/ehsan-darbhangavi?lang=ur
احسان جعفری 	/poets/ehsan-jafri?lang=ur
احسان ثاقب 	/poets/ehsan-saqib?lang=ur
احترام اسلام 	/poets/ehteram-islam?lang=ur
اہتمام صادق 	/poets/ehtimam-sadiq?lang=ur
احتشام اختر 	/poets/ehtisham-akhtar?lang=ur
احتشام حسین 	/poets/ehtisham-husain?lang=ur
احتشام الحق صدیقی 	/poets/ehtisham-ul-haq-siddiqui?lang=ur
احیا بھوجپوری 	/poets/ehya-bhojpuri?lang=ur
اعجاز احمد اعجاز 	/poets/ejaaz-ahamd-ejaaz?lang=ur
اعجاز طالب 	/poets/ejaaz-talib?lang=ur
اعجاز توکل 	/poets/ejaaz-tawakkal?lang=ur
اعجاز آصف 	/poets/ejaz-asif?lang=ur
اعجاز اعظمی 	/poets/ejaz-azmi?lang=ur
اعجاز فاروقی 	/poets/ejaz-farooqi?lang=ur
اعجاز گل 	/poets/ejaz-gul?lang=ur
اعجاز عبید 	/poets/ejaz-obaid?lang=ur
اعجاز راہی 	/poets/ejaz-rahi?lang=ur
اعجاز رحمانی 	/poets/ejaz-rahmani?lang=ur
اعجاز رضوی 	/poets/ejaz-rizvi?lang=ur
اعجاز صدیقی 	/poets/ejaz-siddiqi?lang=ur
اعجاز وارثی 	/poets/ejaz-warsi?lang=ur
ایلزبتھ کورین مونا 	/poets/elizabeth-kurian-mona?lang=ur
ارم زہرا 	/poets/erum-zehra?lang=ur
اعتبار ساجد 	/poets/etibar-sajid?lang=ur
اعزاز افصل 	/poets/ezaz-afzal?lang=ur
اعزاز احمد آذر 	/poets/ezaz-ahmad-azar?lang=ur
اعزاز کاظمی 	/poets/ezaz-kazmi?lang=ur
فائز دہلوی 	/poets/faez-dehlvi?lang=ur
فہیم اعظمی 	/poets/faheem-aazmi?lang=ur
فہیم جوگاپوری 	/poets/faheem-jogapuri?lang=ur
فہیم شناس کاظمی 	/poets/faheem-shanas-kazmi?lang=ur
فہمی بدایونی 	/poets/fahmi-badayuni?lang=ur
فہمیدہ ریاض 	/poets/fahmida-riaz?lang=ur
فیصل عجمی 	/poets/faisal-ajmi?lang=ur
فیصل عظیم 	/poets/faisal-azeem?lang=ur
فیصل فہمی 	/poets/faisal-fehmi?lang=ur
فیصل ہاشمی 	/poets/faisal-hashmi?lang=ur
فیصل سعید ضرغام 	/poets/faisal-saeed-zirgham?lang=ur
فیاض احمد 	/poets/faiyaz-ahmad?lang=ur
فیاض رشک 	/poets/faiyaz-rashk?lang=ur
فیض احمد فیض 	/poets/faiz-ahmad-faiz?lang=ur
فیض عالم بابر 	/poets/faiz-alam-babar?lang=ur
فیض انور 	/poets/faiz-anwar?lang=ur
فیض دکنی 	/poets/faiz-dakani?lang=ur
فیض جونپوری 	/poets/faiz-jaunpuri?lang=ur
فیض خلیل آبادی 	/poets/faiz-khalilabadi?lang=ur
فیض الحسن 	/poets/faiz-ul-hasan?lang=ur
فیضان عارف 	/poets/faizan-arif?lang=ur
فیضان ہاشمی 	/poets/faizan-hashmi?lang=ur
فیضی 	/poets/faizi?lang=ur
فیضی نظام پوری 	/poets/faizi-nizam-puri?lang=ur
فیضی سمبل پوری 	/poets/faizi-sambalpuri?lang=ur
ﻓﺎﺧﺮﮦ ﺑﺘﻮﻝ 	/poets/fakhira-batool?lang=ur
فخر عباس 	/poets/fakhr-abbas?lang=ur
فخر زمان 	/poets/fakhr-zaman?lang=ur
فخر عالم نعمانی 	/poets/fakhr-e-alam-nomani?lang=ur
فنا بلند شہری 	/poets/fana-bulandshahri?lang=ur
فنا نظامی کانپوری 	/poets/fana-nizami-kanpuri?lang=ur
فانی بدایونی 	/poets/fani-badayuni?lang=ur
فانی جودھپوری 	/poets/fani-jodhpuri?lang=ur
فقیہہ حیدر 	/poets/faqeeh-haidar?lang=ur
فراغ روہوی 	/poets/faragh-rohvi?lang=ur
فرح اقبال 	/poets/farah-iqbal?lang=ur
فرح شاہد 	/poets/farah-shahid?lang=ur
فراست رضوی 	/poets/farasat-rizwi?lang=ur
فراز محمود فارز 	/poets/faraz-mahmood-fariz?lang=ur
فراز سلطانپوری 	/poets/faraz-sultanpuri?lang=ur
فرید عشرتی 	/poets/fareed-ishrati?lang=ur
فرید جاوید 	/poets/fareed-javed?lang=ur
فرید پربتی 	/poets/fareed-parbati?lang=ur
فرحان سالم 	/poets/farhan-salim?lang=ur
فرحت عباس 	/poets/farhat-abbas?lang=ur
فرحت عباس شاہ 	/poets/farhat-abbas-shah?lang=ur
فرحت علی خاں 	/poets/farhat-ali-khan?lang=ur
فرحت احساس 	/poets/farhat-ehsas?lang=ur
فرحت کانپوری 	/poets/farhat-kanpuri?lang=ur
فرحت ندیم ہمایوں 	/poets/farhat-nadeem-humayun?lang=ur
فائز دہلوی 	/poets/faez-dehlvi?lang=ur
فہیم اعظمی 	/poets/faheem-aazmi?lang=ur
فہیم جوگاپوری 	/poets/faheem-jogapuri?lang=ur
فہیم شناس کاظمی 	/poets/faheem-shanas-kazmi?lang=ur
فہمی بدایونی 	/poets/fahmi-badayuni?lang=ur
فہمیدہ ریاض 	/poets/fahmida-riaz?lang=ur
فیصل عجمی 	/poets/faisal-ajmi?lang=ur
فیصل عظیم 	/poets/faisal-azeem?lang=ur
فیصل فہمی 	/poets/faisal-fehmi?lang=ur
فیصل ہاشمی 	/poets/faisal-hashmi?lang=ur
فیصل سعید ضرغام 	/poets/faisal-saeed-zirgham?lang=ur
فیاض احمد 	/poets/faiyaz-ahmad?lang=ur
فیاض رشک 	/poets/faiyaz-rashk?lang=ur
فیض احمد فیض 	/poets/faiz-ahmad-faiz?lang=ur
فیض عالم بابر 	/poets/faiz-alam-babar?lang=ur
فیض انور 	/poets/faiz-anwar?lang=ur
فیض دکنی 	/poets/faiz-dakani?lang=ur
فیض جونپوری 	/poets/faiz-jaunpuri?lang=ur
فیض خلیل آبادی 	/poets/faiz-khalilabadi?lang=ur
فیض الحسن 	/poets/faiz-ul-hasan?lang=ur
فیضان عارف 	/poets/faizan-arif?lang=ur
فیضان ہاشمی 	/poets/faizan-hashmi?lang=ur
فیضی 	/poets/faizi?lang=ur
فیضی نظام پوری 	/poets/faizi-nizam-puri?lang=ur
فیضی سمبل پوری 	/poets/faizi-sambalpuri?lang=ur
ﻓﺎﺧﺮﮦ ﺑﺘﻮﻝ 	/poets/fakhira-batool?lang=ur
فخر عباس 	/poets/fakhr-abbas?lang=ur
فخر زمان 	/poets/fakhr-zaman?lang=ur
فخر عالم نعمانی 	/poets/fakhr-e-alam-nomani?lang=ur
فنا بلند شہری 	/poets/fana-bulandshahri?lang=ur
فنا نظامی کانپوری 	/poets/fana-nizami-kanpuri?lang=ur
فانی بدایونی 	/poets/fani-badayuni?lang=ur
فانی جودھپوری 	/poets/fani-jodhpuri?lang=ur
فقیہہ حیدر 	/poets/faqeeh-haidar?lang=ur
فراغ روہوی 	/poets/faragh-rohvi?lang=ur
فرح اقبال 	/poets/farah-iqbal?lang=ur
فرح شاہد 	/poets/farah-shahid?lang=ur
فراست رضوی 	/poets/farasat-rizwi?lang=ur
فراز محمود فارز 	/poets/faraz-mahmood-fariz?lang=ur
فراز سلطانپوری 	/poets/faraz-sultanpuri?lang=ur
فرید عشرتی 	/poets/fareed-ishrati?lang=ur
فرید جاوید 	/poets/fareed-javed?lang=ur
فرید پربتی 	/poets/fareed-parbati?lang=ur
فرحان سالم 	/poets/farhan-salim?lang=ur
فرحت عباس 	/poets/farhat-abbas?lang=ur
فرحت عباس شاہ 	/poets/farhat-abbas-shah?lang=ur
فرحت علی خاں 	/poets/farhat-ali-khan?lang=ur
فرحت احساس 	/poets/farhat-ehsas?lang=ur
فرحت کانپوری 	/poets/farhat-kanpuri?lang=ur
فرحت ندیم ہمایوں 	/poets/farhat-nadeem-humayun?lang=ur
فرحت نادر رضوی 	/poets/farhat-nadir-rizwi?lang=ur
فرحت قادری 	/poets/farhat-qadri?lang=ur
فرحت شہزاد 	/poets/farhat-shahzad?lang=ur
فرحت زاہد 	/poets/farhat-zahid?lang=ur
فارغ بخاری 	/poets/farigh-bukhari?lang=ur
فریحہ نقوی 	/poets/fariha-naqvi?lang=ur
فرحندہ نسرین حیات 	/poets/farkhanda-nasreen-hayat?lang=ur
فروغ حیدرآبادی 	/poets/farogh-haiderabdi?lang=ur
فاروق انجم 	/poets/farooq-anjum?lang=ur
فاروق بخشی 	/poets/farooq-bakshi?lang=ur
فاروق بانسپاری 	/poets/farooq-banspari?lang=ur
فاروق انجینئر 	/poets/farooq-engineer?lang=ur
فاروق مضطر 	/poets/farooq-muztar?lang=ur
فاروق نازکی 	/poets/farooq-nazki?lang=ur
فاروق رحمان 	/poets/farooq-rahman?lang=ur
فاروق شفق 	/poets/farooq-shafaq?lang=ur
فاروق شمیم 	/poets/farooq-shamim?lang=ur
فرخ جعفری 	/poets/farrukh-jafari?lang=ur
فرخ یار 	/poets/farrukh-yar?lang=ur
فرخ زہرا گیلانی 	/poets/farrukh-zohra-gilani?lang=ur
فرتاش سید 	/poets/fartash-syed?lang=ur
فریاد آزر 	/poets/faryad-aazar?lang=ur
فصیح اکمل 	/poets/fasih-akmal?lang=ur
فصیح اللہ نقیب 	/poets/fasihullah-naqeeb?lang=ur
فاطمہ حسن 	/poets/fatima-hasan?lang=ur
فاطمہ وصیہ جائسی 	/poets/fatima-wasia-jayasi?lang=ur
فوق لدھیانوی 	/poets/fauq-ludhianvi?lang=ur
فوزیہ رباب 	/poets/fauziya-rabab?lang=ur
فواد احمد 	/poets/fawad-ahmad?lang=ur
ف س اعجاز 	/poets/fay-seen-ejaz?lang=ur
فیاض فاروقی 	/poets/fayyaz-farooqi?lang=ur
فیاض ہاشمی 	/poets/fayyaz-hashmi?lang=ur
فیاض تحسین 	/poets/fayyaz-tahseen?lang=ur
فیاض الدین صائب 	/poets/fayyazudin-saib?lang=ur
فضا ابن فیضی 	/poets/faza-ibn-e-faizi?lang=ur
فضل حسین صابر 	/poets/fazal-husain-sabir?lang=ur
فاضل انصاری 	/poets/fazil-ansari?lang=ur
فاضل جمیلی 	/poets/fazil-jamili?lang=ur
فضل احمد کریم فضلی 	/poets/fazl-ahmad-kariim-fazli?lang=ur
فضل تابش 	/poets/fazl-tabish?lang=ur
فضل الرحمٰن 	/poets/fazlurrahman?lang=ur
فیروزناطق خسرو 	/poets/feroze-natique-khusro?lang=ur
فدوی لاہوری 	/poets/fidvi-lahori?lang=ur
فگار مرادآبادی 	/poets/figar-muradabadi?lang=ur
فگار اناوی 	/poets/figar-unnavi?lang=ur
فراق گورکھپوری 	/poets/firaq-gorakhpuri?lang=ur
فراق جلال پوری 	/poets/firaq-jalalpuri?lang=ur
فردوس گیاوی 	/poets/firdaus-gayavi?lang=ur
فطرت انصاری 	/poets/fitrat-ansari?lang=ur
فضا جالندھری 	/poets/fiza-jalandharii?lang=ur
فضا کوثری 	/poets/fiza-kausari?lang=ur
فرانس گادلیب کوئن فراسو 	/poets/france-gaudlib-queen-frasco?lang=ur
فرقت کاکوروی 	/poets/furqat-kakorvi?lang=ur
فضیل جعفری 	/poets/fuzail-jafri?lang=ur
غفار بابر 	/poets/gaffar-babar?lang=ur
گنیش بہاری طرز 	/poets/ganesh-bihari-tarz?lang=ur
گوہر بیگم گوہر 	/poets/gauhar-begum-gauhar?lang=ur
گوہر ہوشیارپوری 	/poets/gauhar-hoshiyarpuri?lang=ur
گوہر نوشاہی 	/poets/gauhar-naushahi?lang=ur
گوہر عثمانی 	/poets/gauhar-usmani?lang=ur
گوتم راج رشی 	/poets/gautam-rajrishi?lang=ur
غواص قریشی 	/poets/gawwas-qureshi?lang=ur
گیتانجلی رائے 	/poets/geetanjali-rai?lang=ur
جارج پیش شور 	/poets/george-puech-shor?lang=ur
غالب احمد 	/poets/ghalib-ahmad?lang=ur
غالب ایاز 	/poets/ghalib-ayaz?lang=ur
غالب عرفان 	/poets/ghalib-irfan?lang=ur
غمگین دہلوی 	/poets/ghamgeen-dehlvi?lang=ur
غنی اعجاز 	/poets/ghani-ejaz?lang=ur
غنی غیور 	/poets/ghani-ghayoor?lang=ur
غوث خواہ مخواہ حیدرآبادی 	/poets/ghaus-khah-makhah-hyderabadi?lang=ur
غوث محمد غوثی 	/poets/ghaus-mohammad-ghausi?lang=ur
غوث سیوانی 	/poets/ghaus-siwani?lang=ur
غوثیہ خان سبین 	/poets/ghausiya-khan-sabeen?lang=ur
غیاث انجم 	/poets/ghayas-anjum?lang=ur
غیاث متین 	/poets/ghayas-mateen?lang=ur
غضنفر 	/poets/ghazanfar?lang=ur
غضنفر علی غضنفر 	/poets/ghazanfar-ali-ghazanfar?lang=ur
غضنفر ہاشمی 	/poets/ghazanfar-hashmi?lang=ur
غوث متھراوی 	/poets/ghous-mathravi?lang=ur
غبار بھٹی 	/poets/ghubaar-bhatti?lang=ur
غفران امجد 	/poets/ghufran-amjad?lang=ur
غلام بھیک نیرنگ 	/poets/ghulam-bhik-nairang?lang=ur
غلام حسین ایاز 	/poets/ghulam-husain-ayaz?lang=ur
غلام حسین ساجد 	/poets/ghulam-husain-sajid?lang=ur
غلام مولیٰ قلق 	/poets/ghulam-maula-qalaq?lang=ur
غلام محمد قاصر 	/poets/ghulam-mohammad-qasir?lang=ur
غلام محمد سفیر 	/poets/ghulam-mohammad-safeer?lang=ur
غلام مرتضی راہی 	/poets/ghulam-murtaza-rahi?lang=ur
غلام مصطفی فراز 	/poets/ghulam-mustafa-faraz?lang=ur
غزالہ خاکوانی 	/poets/ghzala-khakwani?lang=ur
غزالہ شاہد 	/poets/ghzala-shahid?lang=ur
گرجا ویاس 	/poets/girija-wiyas?lang=ur
گوبند پرساد 	/poets/gobind-parsad?lang=ur
گوپال کرشن شفق 	/poets/gopal-krishna-shafaq?lang=ur
گوپال متل 	/poets/gopal-mittal?lang=ur
گوپال داس نیرج 	/poets/gopaldas-neeraj?lang=ur
گوپی ناتھ امن 	/poets/gopi-nath-amn?lang=ur
گور بچن سنگھ دیال مغموم 	/poets/gorbachan-singh-dayal-maghmum?lang=ur
گووند گلشن 	/poets/govind-gulshan?lang=ur
گویا فقیر محمد 	/poets/goya-faqir-mohammad?lang=ur
گفتار خیالی 	/poets/guftar-khayali?lang=ur
گہر خیرآبادی 	/poets/guhar-khairabadi?lang=ur
غلام دستگیر مبین 	/poets/gulam-dastgeer-mubeen?lang=ur
غفار بابر 	/poets/gaffar-babar?lang=ur
گنیش بہاری طرز 	/poets/ganesh-bihari-tarz?lang=ur
گوہر بیگم گوہر 	/poets/gauhar-begum-gauhar?lang=ur
گوہر ہوشیارپوری 	/poets/gauhar-hoshiyarpuri?lang=ur
گوہر نوشاہی 	/poets/gauhar-naushahi?lang=ur
گوہر عثمانی 	/poets/gauhar-usmani?lang=ur
گوتم راج رشی 	/poets/gautam-rajrishi?lang=ur
غواص قریشی 	/poets/gawwas-qureshi?lang=ur
گیتانجلی رائے 	/poets/geetanjali-rai?lang=ur
جارج پیش شور 	/poets/george-puech-shor?lang=ur
غالب احمد 	/poets/ghalib-ahmad?lang=ur
غالب ایاز 	/poets/ghalib-ayaz?lang=ur
غالب عرفان 	/poets/ghalib-irfan?lang=ur
غمگین دہلوی 	/poets/ghamgeen-dehlvi?lang=ur
غنی اعجاز 	/poets/ghani-ejaz?lang=ur
غنی غیور 	/poets/ghani-ghayoor?lang=ur
غوث خواہ مخواہ حیدرآبادی 	/poets/ghaus-khah-makhah-hyderabadi?lang=ur
غوث محمد غوثی 	/poets/ghaus-mohammad-ghausi?lang=ur
غوث سیوانی 	/poets/ghaus-siwani?lang=ur
غوثیہ خان سبین 	/poets/ghausiya-khan-sabeen?lang=ur
غیاث انجم 	/poets/ghayas-anjum?lang=ur
غیاث متین 	/poets/ghayas-mateen?lang=ur
غضنفر 	/poets/ghazanfar?lang=ur
غضنفر علی غضنفر 	/poets/ghazanfar-ali-ghazanfar?lang=ur
غضنفر ہاشمی 	/poets/ghazanfar-hashmi?lang=ur
غوث متھراوی 	/poets/ghous-mathravi?lang=ur
غبار بھٹی 	/poets/ghubaar-bhatti?lang=ur
غفران امجد 	/poets/ghufran-amjad?lang=ur
غلام بھیک نیرنگ 	/poets/ghulam-bhik-nairang?lang=ur
غلام حسین ایاز 	/poets/ghulam-husain-ayaz?lang=ur
غلام حسین ساجد 	/poets/ghulam-husain-sajid?lang=ur
غلام مولیٰ قلق 	/poets/ghulam-maula-qalaq?lang=ur
غلام محمد قاصر 	/poets/ghulam-mohammad-qasir?lang=ur
غلام محمد سفیر 	/poets/ghulam-mohammad-safeer?lang=ur
غلام مرتضی راہی 	/poets/ghulam-murtaza-rahi?lang=ur
غلام مصطفی فراز 	/poets/ghulam-mustafa-faraz?lang=ur
غزالہ خاکوانی 	/poets/ghzala-khakwani?lang=ur
غزالہ شاہد 	/poets/ghzala-shahid?lang=ur
گرجا ویاس 	/poets/girija-wiyas?lang=ur
گوبند پرساد 	/poets/gobind-parsad?lang=ur
گوپال کرشن شفق 	/poets/gopal-krishna-shafaq?lang=ur
گوپال متل 	/poets/gopal-mittal?lang=ur
گوپال داس نیرج 	/poets/gopaldas-neeraj?lang=ur
گوپی ناتھ امن 	/poets/gopi-nath-amn?lang=ur
گور بچن سنگھ دیال مغموم 	/poets/gorbachan-singh-dayal-maghmum?lang=ur
گووند گلشن 	/poets/govind-gulshan?lang=ur
گویا فقیر محمد 	/poets/goya-faqir-mohammad?lang=ur
گفتار خیالی 	/poets/guftar-khayali?lang=ur
گہر خیرآبادی 	/poets/guhar-khairabadi?lang=ur
غلام دستگیر مبین 	/poets/gulam-dastgeer-mubeen?lang=ur
غلام جیلانی اصغر 	/poets/gulam-jilani-asghar?lang=ur
غلام نبی اعوان 	/poets/gulam-nabi-aawan?lang=ur
غلام نبی حکیم 	/poets/gulam-nabi-hakeem?lang=ur
غلام رسول طارق 	/poets/gulam-rasool-tariq?lang=ur
غلام یحییٰ حضورعظیم آبادی 	/poets/gulam-yahya-huzur-azimabadi?lang=ur
گلنار آفرین 	/poets/gulnar-aafreen?lang=ur
گلناز کوثر 	/poets/gulnaz-kausar?lang=ur
گلشن بریلوی 	/poets/gulshan-barelvi?lang=ur
گلشن الدولہ بہار 	/poets/gulshan-ud-daula-bahar?lang=ur
گلزار 	/poets/gulzar?lang=ur
گلزار بخاری 	/poets/gulzar-bukhari?lang=ur
گلزار دہلوی 	/poets/gulzar-dehlvi?lang=ur
گلزار وفا چودھری 	/poets/gulzar-vafa-chaudari?lang=ur
گستاخ رامپوری 	/poets/gustakh-rampuri?lang=ur
گیان چند 	/poets/gyan-chand?lang=ur
گیان چند جین 	/poets/gyan-chand-jain?lang=ur
گیان چند منصور 	/poets/gyan-chand-mansoor?lang=ur
حباب ہاشمی 	/poets/habab-hashmi?lang=ur
حباب ترمذی 	/poets/habab-tirmizi?lang=ur
حبیب آروی 	/poets/habeeb-aarvi?lang=ur
حبیب احمد صدیقی 	/poets/habeeb-ahmad-siddiqui?lang=ur
حبیب اشعر دہلوی 	/poets/habeeb-ashar-dehlavi?lang=ur
حبیب فخری 	/poets/habeeb-fakhri?lang=ur
حبیب حیدرآبادی 	/poets/habeeb-hyderabadi?lang=ur
حبیب کیفی 	/poets/habeeb-kaifi?lang=ur
حبیب موسوی 	/poets/habeeb-musvi?lang=ur
حبیب راحت حباب 	/poets/habeeb-rahat-habab?lang=ur
حبیب جالب 	/poets/habib-jalib?lang=ur
حبیب تنویر 	/poets/habib-tanvir?lang=ur
ہادی مچھلی شہری 	/poets/hadi-machlishahri?lang=ur
حادث صلصال 	/poets/hadis-salsal?lang=ur
حفیظ بنارسی 	/poets/hafeez-banarasi?lang=ur
حفیظ فاطمہ بریلوی 	/poets/hafeez-fatima-barelvi?lang=ur
حفیظ ہوشیارپوری 	/poets/hafeez-hoshiarpuri?lang=ur
حفیظ جالندھری 	/poets/hafeez-jalandhari?lang=ur
حفیظ جونپوری 	/poets/hafeez-jaunpuri?lang=ur
حفیظ میرٹھی 	/poets/hafeez-merathi?lang=ur
حفیظ احمد 	/poets/hafiz-ahmad?lang=ur
حافظ لدھیانوی 	/poets/hafiz-ludhiyanvi?lang=ur
حفیظ تائب 	/poets/hafiz-taib?lang=ur
حیدر علی آتش 	/poets/haidar-ali-aatish?lang=ur
حیدر علی جعفری 	/poets/haidar-ali-jafri?lang=ur
حیدر قریشی 	/poets/haidar-qureshi?lang=ur
حیرت الہ آبادی 	/poets/hairat-allahabadi?lang=ur
حیرت گونڈوی 	/poets/hairat-gondvi?lang=ur
حیرت سہروردی 	/poets/hairat-saharvardi?lang=ur
حیرت شملوی 	/poets/hairat-shimlavii?lang=ur
حکیم اسد علی خان مضطر 	/poets/hakeem-asad-ali-khan-muztar?lang=ur
حکیم منظور 	/poets/hakeem-manzoor?lang=ur
حکیم محمد حسین احقرؔ 	/poets/hakeem-mohammad-husain-ahqar?lang=ur
حکیم ناصر 	/poets/hakeem-nasir?lang=ur
حکیم سید محمد غازی پوری 	/poets/hakeem-syed-mohammad-ghazipuri?lang=ur
حکیم محمد اجمل خاں شیدا 	/poets/hakim-mohammad-ajmal-khan-shaida?lang=ur
حلیم قریشی 	/poets/haleem-qureshi?lang=ur
ہمدم کاشمیری 	/poets/hamdam-kashmiri?lang=ur
حمدون عثمانی 	/poets/hamdoon-usmani?lang=ur
حمید الماس 	/poets/hameed-almas-2?lang=ur
حمید گوہر 	/poets/hameed-gauhar?lang=ur
حمید جالندھری 	/poets/hameed-jalandhari?lang=ur
حمید جاذب 	/poets/hameed-jazib?lang=ur
حمید کوثر 	/poets/hameed-kausar?lang=ur
حمید ناگپوری 	/poets/hameed-nag-puri?lang=ur
حمید نسیم 	/poets/hameed-naseem-1?lang=ur
حمید نسیم 	/poets/hameed-naseem?lang=ur
حامد الہ آبادی 	/poets/hamid-allahabadi?lang=ur
حامد حسین حامد 	/poets/hamid-husain-hamid?lang=ur
حامد اقبال صدیقی 	/poets/hamid-iqbal-siddiqui?lang=ur
حباب ہاشمی 	/poets/habab-hashmi?lang=ur
حباب ترمذی 	/poets/habab-tirmizi?lang=ur
حبیب آروی 	/poets/habeeb-aarvi?lang=ur
حبیب احمد صدیقی 	/poets/habeeb-ahmad-siddiqui?lang=ur
حبیب اشعر دہلوی 	/poets/habeeb-ashar-dehlavi?lang=ur
حبیب فخری 	/poets/habeeb-fakhri?lang=ur
حبیب حیدرآبادی 	/poets/habeeb-hyderabadi?lang=ur
حبیب کیفی 	/poets/habeeb-kaifi?lang=ur
حبیب موسوی 	/poets/habeeb-musvi?lang=ur
حبیب راحت حباب 	/poets/habeeb-rahat-habab?lang=ur
حبیب جالب 	/poets/habib-jalib?lang=ur
حبیب تنویر 	/poets/habib-tanvir?lang=ur
ہادی مچھلی شہری 	/poets/hadi-machlishahri?lang=ur
حادث صلصال 	/poets/hadis-salsal?lang=ur
حفیظ بنارسی 	/poets/hafeez-banarasi?lang=ur
حفیظ فاطمہ بریلوی 	/poets/hafeez-fatima-barelvi?lang=ur
حفیظ ہوشیارپوری 	/poets/hafeez-hoshiarpuri?lang=ur
حفیظ جالندھری 	/poets/hafeez-jalandhari?lang=ur
حفیظ جونپوری 	/poets/hafeez-jaunpuri?lang=ur
حفیظ میرٹھی 	/poets/hafeez-merathi?lang=ur
حفیظ احمد 	/poets/hafiz-ahmad?lang=ur
حافظ لدھیانوی 	/poets/hafiz-ludhiyanvi?lang=ur
حفیظ تائب 	/poets/hafiz-taib?lang=ur
حیدر علی آتش 	/poets/haidar-ali-aatish?lang=ur
حیدر علی جعفری 	/poets/haidar-ali-jafri?lang=ur
حیدر قریشی 	/poets/haidar-qureshi?lang=ur
حیرت الہ آبادی 	/poets/hairat-allahabadi?lang=ur
حیرت گونڈوی 	/poets/hairat-gondvi?lang=ur
حیرت سہروردی 	/poets/hairat-saharvardi?lang=ur
حیرت شملوی 	/poets/hairat-shimlavii?lang=ur
حکیم اسد علی خان مضطر 	/poets/hakeem-asad-ali-khan-muztar?lang=ur
حکیم منظور 	/poets/hakeem-manzoor?lang=ur
حکیم محمد حسین احقرؔ 	/poets/hakeem-mohammad-husain-ahqar?lang=ur
حکیم ناصر 	/poets/hakeem-nasir?lang=ur
حکیم سید محمد غازی پوری 	/poets/hakeem-syed-mohammad-ghazipuri?lang=ur
حکیم محمد اجمل خاں شیدا 	/poets/hakim-mohammad-ajmal-khan-shaida?lang=ur
حلیم قریشی 	/poets/haleem-qureshi?lang=ur
ہمدم کاشمیری 	/poets/hamdam-kashmiri?lang=ur
حمدون عثمانی 	/poets/hamdoon-usmani?lang=ur
حمید الماس 	/poets/hameed-almas-2?lang=ur
حمید گوہر 	/poets/hameed-gauhar?lang=ur
حمید جالندھری 	/poets/hameed-jalandhari?lang=ur
حمید جاذب 	/poets/hameed-jazib?lang=ur
حمید کوثر 	/poets/hameed-kausar?lang=ur
حمید ناگپوری 	/poets/hameed-nag-puri?lang=ur
حمید نسیم 	/poets/hameed-naseem-1?lang=ur
حمید نسیم 	/poets/hameed-naseem?lang=ur
حامد الہ آبادی 	/poets/hamid-allahabadi?lang=ur
حامد حسین حامد 	/poets/hamid-husain-hamid?lang=ur
حامد اقبال صدیقی 	/poets/hamid-iqbal-siddiqui?lang=ur
حامد جیلانی 	/poets/hamid-jeelani?lang=ur
حامد کشمیری 	/poets/hamid-kashmeeri?lang=ur
حامد مختار حامد 	/poets/hamid-mukhtar-hamid?lang=ur
حامد سلیم 	/poets/hamid-saleem?lang=ur
حامد سروش 	/poets/hamid-sarosh?lang=ur
حامد یزدانی 	/poets/hamid-yazdani?lang=ur
حامد ظہور 	/poets/hamid-zahoor?lang=ur
حمیدہ شاہین 	/poets/hamida-shahin?lang=ur
حامدی کاشمیری 	/poets/hamidi-kashmiri?lang=ur
حامد اللہ افسر 	/poets/hamidullah-afsar?lang=ur
حماد نیازی 	/poets/hammad-niyazi?lang=ur
حنیف اخگر 	/poets/haneef-akhgar?lang=ur
حنیف اسعدی 	/poets/haneef-asadi?lang=ur
حنیف کیفی 	/poets/haneef-kaifi?lang=ur
حنیف نجمی 	/poets/haneef-najmi?lang=ur
حنیف راہی 	/poets/haneef-rahi?lang=ur
حنیف ساجد 	/poets/haneef-sajid?lang=ur
حنیف فوق 	/poets/hanif-fauq?lang=ur
حنیف ترین 	/poets/hanif-tarin?lang=ur
ہنس راج سچدیو حزیںؔ 	/poets/hans-raj-sachdev-haziin?lang=ur
ہینسن ریحانی 	/poets/hanson-rehani?lang=ur
حقیر 	/poets/haqeer?lang=ur
حقیر جہانی 	/poets/haqeer-jahani?lang=ur
ہربنس لال انیجہ جمالؔ 	/poets/harbans-lal-aneja-jamaal?lang=ur
ہربنس مکھیہ 	/poets/harbans-mukhia-1?lang=ur
ہربنس تصور 	/poets/harbans-tasawwur?lang=ur
ہر بھجن سنگھ سوڑھی بسمل 	/poets/harbhajan-singh-sodhi-bismil?lang=ur
ہری چند اختر 	/poets/hari-chand-akhtar?lang=ur
ہری مہتہ 	/poets/hari-mehta?lang=ur
حارث بلال 	/poets/haris-bilal?lang=ur
حارث خلیق 	/poets/haris-khaleeq?lang=ur
ہرش برہم بھٹ 	/poets/harsh-barham-bhat?lang=ur
حسن عابد 	/poets/hasan-aabid?lang=ur
حسن عباس رضا 	/poets/hasan-abbas-raza?lang=ur
حسن عباسی 	/poets/hasan-abbasi?lang=ur
حسن عابدی 	/poets/hasan-abidi?lang=ur
حسن اکبر کمال 	/poets/hasan-akbar-kamal?lang=ur
حسن اختر جلیل 	/poets/hasan-akhtar-jaleel?lang=ur
حسن عظیم آبادی 	/poets/hasan-azimabadi?lang=ur
حسن عزیز 	/poets/hasan-aziz?lang=ur
حسن بخت 	/poets/hasan-bakht?lang=ur
حسن بریلوی 	/poets/hasan-barelvi?lang=ur
حسن حمیدی 	/poets/hasan-hameedi?lang=ur
حسن جمیل 	/poets/hasan-jameel?lang=ur
حسن کمال 	/poets/hasan-kamal?lang=ur
حسن نعیم 	/poets/hasan-naim?lang=ur
حسن نجمی سکندرپوری 	/poets/hasan-najmi-sikandarpuri?lang=ur
حسن ناصر 	/poets/hasan-nasir?lang=ur
حسن نظامی 	/poets/hasan-nizami?lang=ur
حسن رضوی 	/poets/hasan-rizvi?lang=ur
حسن سوز 	/poets/hasan-soz?lang=ur
حسن طاہر 	/poets/hasan-tahir?lang=ur
حسیب رہبر 	/poets/haseeb-rehbar?lang=ur
حسیب سوز  	/poets/haseeb-soz?lang=ur
حسیب الحسن 	/poets/haseebul-hasan?lang=ur
حصیر نوری 	/poets/haseer-noori?lang=ur
ہاشم علی خاں دلازاک 	/poets/hashim-ali-khan-dilazak?lang=ur
ہاشم رضا جلالپوری 	/poets/hashim-raza-jalalpuri?lang=ur
حسنین عاقب 	/poets/hasnain-aaqib?lang=ur
حسنین جعفری 	/poets/hasnain-jafri?lang=ur
حسرتؔ عظیم آبادی 	/poets/hasrat-azimabadi?lang=ur
حسرت دیوبندی 	/poets/hasrat-deobandi?lang=ur
حسرتؔ جے پوری 	/poets/hasrat-jaipuri?lang=ur
حسرت کمالی 	/poets/hasrat-kamali?lang=ur
حسرتؔ موہانی 	/poets/hasrat-mohani?lang=ur
حسرت شروانی 	/poets/hasrat-sharvani?lang=ur
حسان احمد اعوان 	/poets/hassan-ahmad-awan?lang=ur
ہستی مل ہستی 	/poets/hastimal-hasti?lang=ur
حاتم علی مہر 	/poets/hatim-ali-mehar?lang=ur
حیا لکھنوی 	/poets/haya-lakhnavi?lang=ur
حیات لکھنوی 	/poets/hayat-lakhnavi?lang=ur
حیات مدراسی 	/poets/hayat-madrasi?lang=ur
حیات رضوی امروہوی 	/poets/hayat-rizvi-amrohvi?lang=ur
حیات وارثی 	/poets/hayat-warsi?lang=ur
ہزار لکھنوی 	/poets/hazar-lakhnavi?lang=ur
حزیں لدھیانوی 	/poets/hazin-ludhianvi?lang=ur
ہیرا لال فلک دہلوی 	/poets/heera-lal-falak-dehlvi?lang=ur
ہدایت اللہ خان شمسی 	/poets/hidayatullah-khan-shamsi?lang=ur
حجاب عباسی 	/poets/hijab-abbasi?lang=ur
ہجرؔ ناظم علی خان 	/poets/hijr-nazim-ali-khan?lang=ur
ہلال فرید 	/poets/hilal-fareed?lang=ur
حمایت علی شاعرؔ 	/poets/himayat-ali-shayar?lang=ur
حنا رضوی 	/poets/hina-rizwi?lang=ur
حنا تیموری 	/poets/hina-taimuri?lang=ur
ہندی گورکھپوری 	/poets/hindii-gorakhpurii?lang=ur
ہیرا نند سوزؔ 	/poets/hira-nand-soz?lang=ur
ہوش ترمذی 	/poets/hosh-tirmizi?lang=ur
حمیرا گل تشنہ 	/poets/humaira-gul-tishna?lang=ur
حمیرا راحتؔ 	/poets/humaira-rahat?lang=ur
حمیرا رحمان 	/poets/humaira-rahman?lang=ur
حرمت الااکرام 	/poets/hurmatul-ikaram?lang=ur
حسین عابد 	/poets/husain-abid?lang=ur
حسین مجروح 	/poets/husain-majrooh?lang=ur
حسین سحر 	/poets/husain-sahar?lang=ur
حسین تاج رضوی 	/poets/husain-taj-rizvi?lang=ur
حسین ماجد 	/poets/hussain-majid?lang=ur
حسین میر کاشمیری 	/poets/hussain-meer-kashmiri?lang=ur
ابن انشا 	/poets/ibn-e-insha?lang=ur
ابن مفتی 	/poets/ibn-e-mufti?lang=ur
ابن رضا 	/poets/ibn-e-raza?lang=ur
ابن صفی 	/poets/ibn-e-safi?lang=ur
ابن امید 	/poets/ibn-e-ummeed?lang=ur
ابراہیم ہوش 	/poets/ibraheem-hosh?lang=ur
ابراہیم اشکؔ 	/poets/ibrahim-ashk?lang=ur
عبرت بہرائچی 	/poets/ibrat-bahraichi?lang=ur
عبرت مچھلی شہری 	/poets/ibrat-machlishahri?lang=ur
ادریس بابر 	/poets/idris-babar?lang=ur
عفت عباس 	/poets/iffat-abbas?lang=ur
عفت زریں 	/poets/iffat-zarrin?lang=ur
افتخار اعظمی 	/poets/iftikhar-aazmi?lang=ur
افتخار احمد فخر 	/poets/iftikhar-ahmad-fakhr?lang=ur
افتخار عارف 	/poets/iftikhar-arif?lang=ur
افتخار بخاری 	/poets/iftikhar-bukhari?lang=ur
افتخار فلک کاظمی 	/poets/iftikhar-falak-kazmi?lang=ur
افتخار حسین رضوی سعید 	/poets/iftikhar-husain-rizwi-saeed?lang=ur
افتخار امام صدیقی 	/poets/iftikhar-imam-siddiqi?lang=ur
افتخار جالب 	/poets/iftikhar-jalib?lang=ur
افتخار جمیل شاہین 	/poets/iftikhar-jameel-shaheen?lang=ur
افتخار مغل 	/poets/iftikhar-mughal?lang=ur
افتخار نسیم 	/poets/iftikhar-naseem?lang=ur
افتخار قیصر 	/poets/iftikhar-qaisar?lang=ur
افتخار راغب 	/poets/iftikhar-raghib?lang=ur
افتخار شفیع 	/poets/iftikhar-shafi?lang=ur
اجتبیٰ رضوی 	/poets/ijtiba-rizvi?lang=ur
اکرام اعظم 	/poets/ikram-azam?lang=ur
اکرام جنجیوعہ 	/poets/ikram-janjua?lang=ur
اکرام مجیب 	/poets/ikram-mujeeb?lang=ur
اکرام تبسم 	/poets/ikram-tabassum?lang=ur
الیاس بابر اعوان 	/poets/iliyas-babar-aawan?lang=ur
الیاس عشقی 	/poets/ilyas-ishqi?lang=ur
امام اعظم 	/poets/imam-azam?lang=ur
امام بخش ناسخ 	/poets/imam-bakhsh-nasikh?lang=ur
امداد آکاش 	/poets/imdad-akash?lang=ur
امداد علی بحر 	/poets/shaikh-imdad-ali-bahr-lakhnavi?lang=ur
امداد ہمدانی 	/poets/imdad-hamdani?lang=ur
امداد امام اثرؔ 	/poets/imdad-imam-asar?lang=ur
امداد نظامی 	/poets/imdad-nizaamii?lang=ur
عمران عامی 	/poets/imran-aami?lang=ur
عمران بدایوںی 	/poets/imran-badayuni?lang=ur
عمران ساغر 	/poets/imran-saghar?lang=ur
عمران شمشاد 	/poets/imran-shamshad?lang=ur
عمران شناور 	/poets/imran-shanawar?lang=ur
عمران الحق چوہان 	/poets/imran-ul-haq-chauhan?lang=ur
امتیاز احمد راہی 	/poets/imtiyaz-ahmad-rahi?lang=ur
امتیاز علی گوہر 	/poets/imtiyaz-ali-gauhar?lang=ur
امتیاز خان 	/poets/imtiyaz-khan?lang=ur
امتیاز ساغر 	/poets/imtiyaz-saghar?lang=ur
ابن انشا 	/poets/ibn-e-insha?lang=ur
ابن مفتی 	/poets/ibn-e-mufti?lang=ur
ابن رضا 	/poets/ibn-e-raza?lang=ur
ابن صفی 	/poets/ibn-e-safi?lang=ur
ابن امید 	/poets/ibn-e-ummeed?lang=ur
ابراہیم ہوش 	/poets/ibraheem-hosh?lang=ur
ابراہیم اشکؔ 	/poets/ibrahim-ashk?lang=ur
عبرت بہرائچی 	/poets/ibrat-bahraichi?lang=ur
عبرت مچھلی شہری 	/poets/ibrat-machlishahri?lang=ur
ادریس بابر 	/poets/idris-babar?lang=ur
عفت عباس 	/poets/iffat-abbas?lang=ur
عفت زریں 	/poets/iffat-zarrin?lang=ur
افتخار اعظمی 	/poets/iftikhar-aazmi?lang=ur
افتخار احمد فخر 	/poets/iftikhar-ahmad-fakhr?lang=ur
افتخار عارف 	/poets/iftikhar-arif?lang=ur
افتخار بخاری 	/poets/iftikhar-bukhari?lang=ur
افتخار فلک کاظمی 	/poets/iftikhar-falak-kazmi?lang=ur
افتخار حسین رضوی سعید 	/poets/iftikhar-husain-rizwi-saeed?lang=ur
افتخار امام صدیقی 	/poets/iftikhar-imam-siddiqi?lang=ur
افتخار جالب 	/poets/iftikhar-jalib?lang=ur
افتخار جمیل شاہین 	/poets/iftikhar-jameel-shaheen?lang=ur
افتخار مغل 	/poets/iftikhar-mughal?lang=ur
افتخار نسیم 	/poets/iftikhar-naseem?lang=ur
افتخار قیصر 	/poets/iftikhar-qaisar?lang=ur
افتخار راغب 	/poets/iftikhar-raghib?lang=ur
افتخار شفیع 	/poets/iftikhar-shafi?lang=ur
اجتبیٰ رضوی 	/poets/ijtiba-rizvi?lang=ur
اکرام اعظم 	/poets/ikram-azam?lang=ur
اکرام جنجیوعہ 	/poets/ikram-janjua?lang=ur
اکرام مجیب 	/poets/ikram-mujeeb?lang=ur
اکرام تبسم 	/poets/ikram-tabassum?lang=ur
الیاس بابر اعوان 	/poets/iliyas-babar-aawan?lang=ur
الیاس عشقی 	/poets/ilyas-ishqi?lang=ur
امام اعظم 	/poets/imam-azam?lang=ur
امام بخش ناسخ 	/poets/imam-bakhsh-nasikh?lang=ur
امداد آکاش 	/poets/imdad-akash?lang=ur
امداد علی بحر 	/poets/shaikh-imdad-ali-bahr-lakhnavi?lang=ur
امداد ہمدانی 	/poets/imdad-hamdani?lang=ur
امداد امام اثرؔ 	/poets/imdad-imam-asar?lang=ur
امداد نظامی 	/poets/imdad-nizaamii?lang=ur
عمران عامی 	/poets/imran-aami?lang=ur
عمران بدایوںی 	/poets/imran-badayuni?lang=ur
عمران ساغر 	/poets/imran-saghar?lang=ur
عمران شمشاد 	/poets/imran-shamshad?lang=ur
عمران شناور 	/poets/imran-shanawar?lang=ur
عمران الحق چوہان 	/poets/imran-ul-haq-chauhan?lang=ur
امتیاز احمد راہی 	/poets/imtiyaz-ahmad-rahi?lang=ur
امتیاز علی گوہر 	/poets/imtiyaz-ali-gauhar?lang=ur
امتیاز خان 	/poets/imtiyaz-khan?lang=ur
امتیاز ساغر 	/poets/imtiyaz-saghar?lang=ur
امتیاز الحق امتیاز 	/poets/imtiyaz-ul-haq-imtiyaz?lang=ur
انعام عازمی 	/poets/inaam-azmi?lang=ur
انعام حنفی 	/poets/inaam-hanafi?lang=ur
انعام درانی 	/poets/inam-durrani?lang=ur
انعام کبیر 	/poets/inam-kabeer?lang=ur
انعام ندیمؔ 	/poets/inam-nadeem?lang=ur
انعام الحق جاوید 	/poets/inam-ul-haq-javed?lang=ur
اندر سرازی 	/poets/inder-saraazi?lang=ur
اندرا ورما 	/poets/indira-varma?lang=ur
اندر موہن مہتا کیف 	/poets/indr-mohan-mehta-kaif?lang=ur
اندر سروپ سریواستو 	/poets/indr-swarup-srivastava?lang=ur
انجیل صحیفہ 	/poets/injeel-saheefa?lang=ur
انجلا ہمیش 	/poets/injila-hamesh?lang=ur
انشاءؔ اللہ خاں 	/poets/insha-allah-khan-insha?lang=ur
انتصار حسین عابدی شاہد 	/poets/intesar-husain-abidi-shahid?lang=ur
انتخاب عالم 	/poets/intikhab-alam?lang=ur
انتخاب سید 	/poets/intikhab-syed?lang=ur
انتظار غازی پوری 	/poets/intizar-ghazipuri?lang=ur
اقبال عابدی 	/poets/iqbal-abidi?lang=ur
اقبال انجم 	/poets/iqbal-anjum?lang=ur
اقبال اشہر 	/poets/iqbal-ashhar?lang=ur
اقبال اشہر قریشی 	/poets/iqbal-ashhar-qureshi?lang=ur
اقبال آصف 	/poets/iqbal-asif?lang=ur
اقبال عظیم 	/poets/iqbal-azeem?lang=ur
اقبال حیدر 	/poets/iqbal-haider?lang=ur
اقبال حیدری 	/poets/iqbal-haidri?lang=ur
اقبال حسین رضوی اقبال 	/poets/iqbal-husain-rizvi-iqbal?lang=ur
اقبال کیفی 	/poets/iqbal-kaifi?lang=ur
اقبال کوثر 	/poets/iqbal-kausar?lang=ur
اقبال خسرو قادری 	/poets/iqbal-khusro-qadri?lang=ur
اقبال ماہر 	/poets/iqbal-mahir?lang=ur
اقبال متین 	/poets/iqbal-mateen?lang=ur
اقبال منہاس 	/poets/iqbal-minhas?lang=ur
اقبال ناظر 	/poets/iqbal-naazir?lang=ur
اقبال نوید 	/poets/iqbal-naved?lang=ur
اقبال پیام 	/poets/iqbal-payam?lang=ur
اقبال صفی پوری 	/poets/iqbal-safi-puri?lang=ur
اقبال ساجد 	/poets/iqbal-sajid?lang=ur
اقبال سہیل 	/poets/iqbal-suhail?lang=ur
اقبال عمر 	/poets/iqbal-umar?lang=ur
اقرا عافیہ  new	/poets/iqra-afiya?lang=ur
اقتدار جاوید 	/poets/iqtidar-javed?lang=ur
ارم لکھنوی 	/poets/iram-lakhnavi?lang=ur
عرفان احمد 	/poets/irfan-ahmad?lang=ur
عرفان احمد میر 	/poets/irfan-ahmad-mir?lang=ur
عرفان پربھنوی 	/poets/irfan-parbhanvi?lang=ur
عرفان ستار 	/poets/irfan-sattar?lang=ur
عرفانؔ صدیقی 	/poets/irfan-siddiqi?lang=ur
عرفان وحید 	/poets/irfan-waheed?lang=ur
عرفانہ عزیز 	/poets/irfana-azeez?lang=ur
عرفان اللہ عرفان 	/poets/irfanullah-irfan?lang=ur
ارشاد ارشی 	/poets/irshad-arshii?lang=ur
ارشاد حسین کاظمی 	/poets/irshad-husain-kazmi?lang=ur
ارشاد کامل 	/poets/irshad-kamil?lang=ur
ارشاد خان سکندر 	/poets/irshad-khan-sikandar?lang=ur
ارشاد شیخ 	/poets/irshad-shaikh?lang=ur
ارتضی نشاط 	/poets/irtiza-nishat?lang=ur
اسحاق ظفر 	/poets/ishaq-zafar?lang=ur
اسحاق اطہر صدیقی 	/poets/ishaq-athar-siddiqui?lang=ur
اسحاق وردگ 	/poets/ishaq-virdag?lang=ur
عشق اورنگ آبادی 	/poets/ishq-aurangabadi?lang=ur
عشق عظیم آبادی 	/poets/ishq-azimabadi?lang=ur
اشراق عزیزی 	/poets/ishraque-azizi?lang=ur
عشرت آفریں 	/poets/ishrat-afreen?lang=ur
عشرت انور 	/poets/ishrat-anwar?lang=ur
عشرت کرتپوری 	/poets/ishrat-kiratpuri?lang=ur
عشرت قادری 	/poets/ishrat-qadri?lang=ur
عشرت رومانی 	/poets/ishrat-rumani?lang=ur
عشرت ظفر 	/poets/ishrat-zafar?lang=ur
اشتیاق طالب 	/poets/ishtiyaq-talib?lang=ur
اسلام عظمی 	/poets/islam-uzma?lang=ur
اسماعیلؔ میرٹھی 	/poets/ismail-merathi?lang=ur
اظہار ملیح آبادی 	/poets/izhaar-malihabadi?lang=ur
اظہار اثر 	/poets/izhar-asar?lang=ur
اظہار وارثی 	/poets/izhar-warsi?lang=ur
جے پی سعید 	/poets/j-p-saeed?lang=ur
جاں نثاراختر 	/poets/jaan-nisar-akhtar?lang=ur
جاناں ملک 	/poets/jaanaan-malik?lang=ur
جبّار جمیل 	/poets/jabbar-jameel?lang=ur
جعفر عباس 	/poets/jafar-abbas?lang=ur
جعفر عباس صفوی 	/poets/jafar-abbas-safvi?lang=ur
جعفر علی حسرت 	/poets/jafar-ali-hasrat?lang=ur
جعفر بلوچ 	/poets/jafar-baluch?lang=ur
جعفر رضا 	/authors/jafar-raza?lang=ur
جعفر ساہنی 	/poets/jafar-sahni?lang=ur
جعفر شیرازی 	/poets/jafar-shirazi?lang=ur
جعفر طاہر 	/poets/jafar-tahir?lang=ur
جگن ناتھ آزادؔ 	/poets/jagan-nath-azad?lang=ur
جگت موہن لال رواںؔ 	/poets/jagat-mohan-lal-ravan?lang=ur
جگدیش پرکاش 	/poets/jagdeesh-parkash?lang=ur
جگدیش راج فگار 	/poets/jagdeesh-raj-figar?lang=ur
جگدیش سہائے سکسینہ 	/poets/jagdish-sahay-saxena?lang=ur
جہانگیر عمران 	/poets/jahangeer-imran?lang=ur
جہانگیر نایاب 	/poets/jahangeer-nayab?lang=ur
جیمنی سرشار 	/poets/jaimini-sarshar?lang=ur
جلالؔ لکھنوی 	/poets/jalal-lakhnavi?lang=ur
جلال الدین اکبر 	/poets/jalaluddin-akbar?lang=ur
جلی امروہوی 	/poets/jalee-amrohvi?lang=ur
جلیل عالیؔ 	/poets/jaleel-aali?lang=ur
جلیل الہ آبادی 	/poets/jaleel-allahabadi?lang=ur
جلیل فتح پوری 	/poets/jaleel-fatehpuri?lang=ur
جلیل حیدر لاشاری 	/poets/jaleel-haider-lashari?lang=ur
جلیل حشمی 	/poets/jaleel-hashmi?lang=ur
جلیلؔ مانک پوری 	/poets/jaleel-manikpuri?lang=ur
جلیل قدوائی 	/poets/jaleel-qidwai?lang=ur
جلیل ساز 	/poets/jaleel-saz?lang=ur
جلیل شیر کوٹی 	/poets/jaleel-sherkoti?lang=ur
جالب نعمانی 	/poets/jalib-nomani?lang=ur
جمال احسانی 	/poets/jamal-ehsani?lang=ur
جمال اویسی 	/poets/jamal-owaisi?lang=ur
جمال پانی پتی 	/poets/jamal-panipati?lang=ur
جمیل عظیم آبادی 	/poets/jameel-azimabadi?lang=ur
جمیل ہمدم 	/poets/jameel-hamdam?lang=ur
جمیل ملک 	/poets/jameel-malik?lang=ur
جمیلؔ مظہری 	/poets/jameel-mazhari?lang=ur
جمیل قریشی 	/poets/jameel-qureshi?lang=ur
جمیل الرحمن 	/poets/jameel-ur-rahman?lang=ur
جمیل عثمان 	/poets/jameel-usman?lang=ur
جمیل یوسف 	/poets/jameel-yusuf?lang=ur
جمیلہ خاتون تسنیم 	/poets/jameela-khatoon-tasneem?lang=ur
جمیلہ خدا بخش 	/poets/jameela-khuda-bakhsh?lang=ur
جمیل الدین عالی 	/poets/jameeluddin-aali?lang=ur
جمیل الدین قادری 	/poets/jameeluddin-qadri?lang=ur
جامی ردولوی 	/poets/jami-rudaulvi?lang=ur
جمیل نظر 	/poets/jamil-nazar?lang=ur
جے پی سعید 	/poets/j-p-saeed?lang=ur
جاں نثاراختر 	/poets/jaan-nisar-akhtar?lang=ur
جاناں ملک 	/poets/jaanaan-malik?lang=ur
جبّار جمیل 	/poets/jabbar-jameel?lang=ur
جعفر عباس 	/poets/jafar-abbas?lang=ur
جعفر عباس صفوی 	/poets/jafar-abbas-safvi?lang=ur
جعفر علی حسرت 	/poets/jafar-ali-hasrat?lang=ur
جعفر بلوچ 	/poets/jafar-baluch?lang=ur
جعفر رضا 	/authors/jafar-raza?lang=ur
جعفر ساہنی 	/poets/jafar-sahni?lang=ur
جعفر شیرازی 	/poets/jafar-shirazi?lang=ur
جعفر طاہر 	/poets/jafar-tahir?lang=ur
جگن ناتھ آزادؔ 	/poets/jagan-nath-azad?lang=ur
جگت موہن لال رواںؔ 	/poets/jagat-mohan-lal-ravan?lang=ur
جگدیش پرکاش 	/poets/jagdeesh-parkash?lang=ur
جگدیش راج فگار 	/poets/jagdeesh-raj-figar?lang=ur
جگدیش سہائے سکسینہ 	/poets/jagdish-sahay-saxena?lang=ur
جہانگیر عمران 	/poets/jahangeer-imran?lang=ur
جہانگیر نایاب 	/poets/jahangeer-nayab?lang=ur
جیمنی سرشار 	/poets/jaimini-sarshar?lang=ur
جلالؔ لکھنوی 	/poets/jalal-lakhnavi?lang=ur
جلال الدین اکبر 	/poets/jalaluddin-akbar?lang=ur
جلی امروہوی 	/poets/jalee-amrohvi?lang=ur
جلیل عالیؔ 	/poets/jaleel-aali?lang=ur
جلیل الہ آبادی 	/poets/jaleel-allahabadi?lang=ur
جلیل فتح پوری 	/poets/jaleel-fatehpuri?lang=ur
جلیل حیدر لاشاری 	/poets/jaleel-haider-lashari?lang=ur
جلیل حشمی 	/poets/jaleel-hashmi?lang=ur
جلیلؔ مانک پوری 	/poets/jaleel-manikpuri?lang=ur
جلیل قدوائی 	/poets/jaleel-qidwai?lang=ur
جلیل ساز 	/poets/jaleel-saz?lang=ur
جلیل شیر کوٹی 	/poets/jaleel-sherkoti?lang=ur
جالب نعمانی 	/poets/jalib-nomani?lang=ur
جمال احسانی 	/poets/jamal-ehsani?lang=ur
جمال اویسی 	/poets/jamal-owaisi?lang=ur
جمال پانی پتی 	/poets/jamal-panipati?lang=ur
جمیل عظیم آبادی 	/poets/jameel-azimabadi?lang=ur
جمیل ہمدم 	/poets/jameel-hamdam?lang=ur
جمیل ملک 	/poets/jameel-malik?lang=ur
جمیلؔ مظہری 	/poets/jameel-mazhari?lang=ur
جمیل قریشی 	/poets/jameel-qureshi?lang=ur
جمیل الرحمن 	/poets/jameel-ur-rahman?lang=ur
جمیل عثمان 	/poets/jameel-usman?lang=ur
جمیل یوسف 	/poets/jameel-yusuf?lang=ur
جمیلہ خاتون تسنیم 	/poets/jameela-khatoon-tasneem?lang=ur
جمیلہ خدا بخش 	/poets/jameela-khuda-bakhsh?lang=ur
جمیل الدین عالی 	/poets/jameeluddin-aali?lang=ur
جمیل الدین قادری 	/poets/jameeluddin-qadri?lang=ur
جامی ردولوی 	/poets/jami-rudaulvi?lang=ur
جمیل نظر 	/poets/jamil-nazar?lang=ur
جمیلؔ مرصع پوری 	/poets/jamill-murassapuri?lang=ur
جمشید آفاق 	/poets/jamshed-afaq?lang=ur
جمشید مسرور 	/poets/jamshed-masroor?lang=ur
جمنا پرشاد راہیؔ 	/poets/jamuna-parsad-rahi?lang=ur
جان کاشمیری 	/poets/jan-kashmiri?lang=ur
جرار چھولسی 	/poets/jarrar-chhaulisi?lang=ur
جتندر پرواز 	/poets/jatinder-parwaaz?lang=ur
جتیندر ویر یخمی جے ویرؔ 	/poets/jatinder-vir-yakhmi-jayaveer?lang=ur
جوہر میر 	/poets/jauhar-meer?lang=ur
جوہر نظامی 	/poets/jauhar-nizami?lang=ur
جوہر سیوانی 	/poets/jauhar-siwani?lang=ur
جوہر زاہری 	/poets/jauhar-zahiri?lang=ur
جون ایلیا 	/poets/jaun-eliya?lang=ur
جاوید انور 	/poets/javaid-anwar?lang=ur
جاوید احمد 	/poets/javed-ahmad?lang=ur
جاوید اختر 	/poets/javed-akhtar?lang=ur
جاوید اکرم فاروقی 	/poets/javed-akram-farooqi?lang=ur
جاوید جمیل 	/poets/javed-jameel?lang=ur
جاوید کمال رامپوری 	/poets/javed-kamal-rampuri?lang=ur
جاوید لاہوری 	/poets/javed-lahori?lang=ur
جاوید لکھنوی 	/poets/javed-lakhnvi?lang=ur
جاوید ندیم 	/poets/javed-nadeem?lang=ur
جاوید نسیمی 	/poets/javed-naseemi?lang=ur
جاوید ناصر 	/poets/javed-nasir?lang=ur
جاوید قریشی 	/poets/javed-quraishi?lang=ur
جاوید صبا 	/poets/javed-saba?lang=ur
جاوید شاہین 	/poets/javed-shaheen?lang=ur
جاوید صدیقی اعظمی 	/poets/javed-siddiqi-azmi?lang=ur
جاوید وششٹ 	/poets/javed-vashisht?lang=ur
جواد شیخ 	/poets/jawad-sheikh?lang=ur
جواز جعفری 	/poets/jawaz-jafri?lang=ur
جاوید منظر 	/poets/jawed-manzar-1?lang=ur
جینت پرمار 	/poets/jayant-parmar?lang=ur
جاذب قریشی 	/poets/jazib-quraishi?lang=ur
جیم جاذل 	/poets/jeem-jazil?lang=ur
جگر بریلوی 	/poets/jigar-barelvi?lang=ur
جگرؔ بسوانی 	/poets/jigar-biswani?lang=ur
جگر جالندھری 	/poets/jigar-jalandhari?lang=ur
جگر مراد آبادی 	/poets/jigar-moradabadi?lang=ur
جیلانی کامران 	/poets/jilani-kamran?lang=ur
جتیندر موہن سنہا رہبر 	/poets/jitendra-mohan-sinha-rahbar?lang=ur
جوشؔ ملیح آبادی 	/poets/josh-malihabadi?lang=ur
جوشؔ ملسیانی 	/poets/josh-malsiani?lang=ur
جوشش عظیم آبادی 	/poets/joshish-azimabadi?lang=ur
جولیس نحیف دہلوی 	/poets/julius-naheef-dehlvi?lang=ur
جنبش خیرآبادی 	/poets/jumbish-khairabadi?lang=ur
جنید اختر 	/poets/junaid-akhtar?lang=ur
جنید حزیں لاری 	/poets/junaid-hazin-lari?lang=ur
جرأت قلندر بخش 	/poets/jurat-qalandar-bakhsh?lang=ur
جرم محمد آبادی 	/poets/jurm-mohammadabadi?lang=ur
جیوتی آزاد کھتری 	/poets/jyoti-azad-khatri?lang=ur
کامی شاہ 	/poets/kaami-shah?lang=ur
کبیر اطہر 	/poets/kabeer-athar?lang=ur
کبیر اجمل 	/poets/kabir-ajmal?lang=ur
کفیل آزر امروہوی 	/poets/kafeel-aazar-amrohvi?lang=ur
کیف احمد صدیقی 	/poets/kaif-ahmed-siddiqui?lang=ur
کیف انصاری 	/poets/kaif-ansari?lang=ur
کیف عظیم آبادی 	/poets/kaif-azimabadi?lang=ur
کیف بھوپالی 	/poets/kaif-bhopali?lang=ur
کیف اکرامی 	/poets/kaif-ikrami?lang=ur
کیفی اعظمی 	/poets/kaifi-azmi?lang=ur
کیفی حیدرآبادی 	/poets/kaifi-hyderabadi?lang=ur
کیفی وجدانی 	/poets/kaifi-wijdani?lang=ur
کیلاش ماہر 	/poets/kailash-mahir?lang=ur
کلیم عاجز 	/poets/kaleem-aajiz?lang=ur
کلیم احمدآبادی 	/poets/kaleem-ahmadabadi?lang=ur
کلیم حیدر شرر 	/poets/kaleem-haider-sharar?lang=ur
کلیم سہسرامی 	/poets/kaleem-sahasrami?lang=ur
کلیم عثمانی 	/poets/kaleem-usmani?lang=ur
کالی داس گپتا رضا 	/poets/kalidas-gupta-raza?lang=ur
کلیم اختر 	/poets/kalim-akhtar?lang=ur
کمال احمد صدیقی 	/poets/kamal-ahmad-siddiqi?lang=ur
کمال جعفری 	/poets/kamal-jafari?lang=ur
کمل اپادھیائے 	/poets/kamal-upadhyay?lang=ur
کامل اختر 	/poets/kamil-akhtar?lang=ur
کاملؔ بہزادی 	/poets/kamil-bahzadi?lang=ur
کامران عادل 	/poets/kamran-adil?lang=ur
کامران غنی صبا 	/poets/kamran-ghani-saba?lang=ur
کامران ندیم 	/poets/kamran-nadeem?lang=ur
کانتی موہن سوز 	/poets/kanti-mohan-soz?lang=ur
کنولؔ ڈبائیوی 	/poets/kanval-dibaivi?lang=ur
کنول ایم۔اے 	/poets/kanval-ma?lang=ur
کنول ضیائی 	/poets/kanval-ziai?lang=ur
کنول فیروز 	/poets/kanwal-feroz?lang=ur
کنول سیالکوٹی 	/poets/kanwal-siyalkoti?lang=ur
کرم حیدری 	/poets/karam-haidari?lang=ur
کرم حیدرآبادی 	/poets/karam-hyderabadi?lang=ur
کرامت علی کرامت 	/poets/karamat-ali-karamat?lang=ur
کرامت علی شہیدی 	/poets/karamat-ali-shaheedi?lang=ur
کرامت بخاری  	/poets/karamat-bukhari?lang=ur
کرن سنگھ کرن 	/poets/karan-singh-karan?lang=ur
کریم الدین صنعت مرادآبادی 	/poets/karimuddin-sanat-moradabadi?lang=ur
کرار نوری 	/poets/karrar-noori?lang=ur
کشفی لکھنؤی 	/poets/kashfi-lucknavi?lang=ur
کشفی ملتانی 	/poets/kashfi-multani?lang=ur
کاشف حسین غائر 	/poets/kashif-husain-ghair?lang=ur
کاشف مجید 	/poets/kashif-majeed?lang=ur
کاشف رفیق 	/poets/kashif-rafiq?lang=ur
کشمیری لال ذاکر 	/poets/kashmiri-lal-zakir?lang=ur
کوکب شاہجہانپوری 	/poets/kaukab-shahjahanpuri?lang=ur
کوثر جائسی 	/poets/kausar-jayasi?lang=ur
کامی شاہ 	/poets/kaami-shah?lang=ur
کبیر اطہر 	/poets/kabeer-athar?lang=ur
کبیر اجمل 	/poets/kabir-ajmal?lang=ur
کفیل آزر امروہوی 	/poets/kafeel-aazar-amrohvi?lang=ur
کیف احمد صدیقی 	/poets/kaif-ahmed-siddiqui?lang=ur
کیف انصاری 	/poets/kaif-ansari?lang=ur
کیف عظیم آبادی 	/poets/kaif-azimabadi?lang=ur
کیف بھوپالی 	/poets/kaif-bhopali?lang=ur
کیف اکرامی 	/poets/kaif-ikrami?lang=ur
کیفی اعظمی 	/poets/kaifi-azmi?lang=ur
کیفی حیدرآبادی 	/poets/kaifi-hyderabadi?lang=ur
کیفی وجدانی 	/poets/kaifi-wijdani?lang=ur
کیلاش ماہر 	/poets/kailash-mahir?lang=ur
کلیم عاجز 	/poets/kaleem-aajiz?lang=ur
کلیم احمدآبادی 	/poets/kaleem-ahmadabadi?lang=ur
کلیم حیدر شرر 	/poets/kaleem-haider-sharar?lang=ur
کلیم سہسرامی 	/poets/kaleem-sahasrami?lang=ur
کلیم عثمانی 	/poets/kaleem-usmani?lang=ur
کالی داس گپتا رضا 	/poets/kalidas-gupta-raza?lang=ur
کلیم اختر 	/poets/kalim-akhtar?lang=ur
کمال احمد صدیقی 	/poets/kamal-ahmad-siddiqi?lang=ur
کمال جعفری 	/poets/kamal-jafari?lang=ur
کمل اپادھیائے 	/poets/kamal-upadhyay?lang=ur
کامل اختر 	/poets/kamil-akhtar?lang=ur
کاملؔ بہزادی 	/poets/kamil-bahzadi?lang=ur
کامران عادل 	/poets/kamran-adil?lang=ur
کامران غنی صبا 	/poets/kamran-ghani-saba?lang=ur
کامران ندیم 	/poets/kamran-nadeem?lang=ur
کانتی موہن سوز 	/poets/kanti-mohan-soz?lang=ur
کنولؔ ڈبائیوی 	/poets/kanval-dibaivi?lang=ur
کنول ایم۔اے 	/poets/kanval-ma?lang=ur
کنول ضیائی 	/poets/kanval-ziai?lang=ur
کنول فیروز 	/poets/kanwal-feroz?lang=ur
کنول سیالکوٹی 	/poets/kanwal-siyalkoti?lang=ur
کرم حیدری 	/poets/karam-haidari?lang=ur
کرم حیدرآبادی 	/poets/karam-hyderabadi?lang=ur
کرامت علی کرامت 	/poets/karamat-ali-karamat?lang=ur
کرامت علی شہیدی 	/poets/karamat-ali-shaheedi?lang=ur
کرامت بخاری  	/poets/karamat-bukhari?lang=ur
کرن سنگھ کرن 	/poets/karan-singh-karan?lang=ur
کریم الدین صنعت مرادآبادی 	/poets/karimuddin-sanat-moradabadi?lang=ur
کرار نوری 	/poets/karrar-noori?lang=ur
کشفی لکھنؤی 	/poets/kashfi-lucknavi?lang=ur
کشفی ملتانی 	/poets/kashfi-multani?lang=ur
کاشف حسین غائر 	/poets/kashif-husain-ghair?lang=ur
کاشف مجید 	/poets/kashif-majeed?lang=ur
کاشف رفیق 	/poets/kashif-rafiq?lang=ur
کشمیری لال ذاکر 	/poets/kashmiri-lal-zakir?lang=ur
کوکب شاہجہانپوری 	/poets/kaukab-shahjahanpuri?lang=ur
کوثر جائسی 	/poets/kausar-jayasi?lang=ur
کوثر محمود 	/poets/kausar-mahmood?lang=ur
کوثر مظہری 	/poets/kausar-mazhari?lang=ur
کوثر نیازی 	/poets/kausar-niyazi?lang=ur
کوثر سیوانی 	/poets/kausar-siwani?lang=ur
کاوش بدری 	/poets/kavish-badri?lang=ur
کاوش بٹ 	/poets/kavish-bat?lang=ur
کویتا کرن 	/poets/kavita-kiran?lang=ur
کاظم حسین کاظم 	/poets/kazim-husain-kazim?lang=ur
کیول کرشن رشیؔ 	/poets/kewal-krishan-rishi?lang=ur
خاور اعجاز 	/poets/khaavar-ejaz?lang=ur
خاور جیلانی 	/poets/khaavar-jilani?lang=ur
خدیجہ خان 	/poets/khadija-khan?lang=ur
خادم رزمی 	/poets/khadim-razmi?lang=ur
خلیل افراز 	/poets/khaleel-afraz?lang=ur
خلیل مامون 	/poets/khaleel-mamoon?lang=ur
خلیل راضی 	/poets/khaleel-raazi?lang=ur
خلیل رامپوری 	/poets/khaleel-rampuri?lang=ur
خلیل تنویر 	/poets/khaleel-tanveer?lang=ur
خلیق قریشی 	/poets/khaleeq-qureshi?lang=ur
خلیق صدیقی 	/poets/khaleeq-siddiqui?lang=ur
خالد احمد 	/poets/khalid-ahmad?lang=ur
خالد علیگ 	/poets/khalid-alig?lang=ur
خالد عبادی 	/poets/khalid-ebadi?lang=ur
خالد فتح پوری 	/poets/khalid-fatehpuri?lang=ur
خالد غنی  	/poets/khalid-ghani?lang=ur
خالد حسن قادری 	/poets/khalid-hasan-qadiri?lang=ur
خالد اقبال تائب 	/poets/khalid-iqbal-taib?lang=ur
خالد اقبال یاسر 	/poets/khalid-iqbal-yasir?lang=ur
خالد عرفان 	/poets/khalid-irfan?lang=ur
خالد جمال 	/poets/khalid-jamal?lang=ur
خالد کرار 	/poets/khalid-karrar?lang=ur
خالد خواجہ 	/poets/khalid-khwaja?lang=ur
خالد محبوب 	/poets/khalid-mahboob?lang=ur
خالد ؔمحمود 	/poets/khalid-mahmood?lang=ur
خالد محمود امر 	/poets/khalid-mahmood-amar?lang=ur
خالد محمود ذکی 	/poets/khalid-mahmood-zaki?lang=ur
خالد ملک ساحلؔ 	/poets/khalid-malik-sahil?lang=ur
خالد معین 	/poets/khalid-moin?lang=ur
خالد مبشر 	/poets/khalid-mubashshir?lang=ur
خالد رحیم 	/poets/khalid-raheem?lang=ur
خالد شریف 	/poets/khalid-sharif?lang=ur
خالد شیرازی 	/poets/khalid-shirazi?lang=ur
خالد صدیقی 	/poets/khalid-siddiqui?lang=ur
خالد سہیل 	/poets/khalid-suhail?lang=ur
خالد یوسف 	/poets/khalid-yusuf?lang=ur
خالدہ عظمی 	/poets/khalida-uzma?lang=ur
خلیل الرحمن اعظمی 	/poets/khalilur-rahman-azmi?lang=ur
خلیل الرحمٰن راز 	/poets/khalilur-rahman-raz?lang=ur
خالق عبداللہ 	/poets/khaliq-aashiq-abdullah?lang=ur
خلش بڑودوی 	/poets/khalish-barodvi?lang=ur
خلش دہلوی 	/poets/khalish-dehlvi?lang=ur
خلش کلکتوی 	/poets/khalish-kalkatvi?lang=ur
خاموش غازی پوری 	/poets/khamosh-ghazipuri?lang=ur
خاں آرزو سراج الدین علی 	/poets/khan-arzoo-sirajuddin-ali?lang=ur
خان جانباز 	/poets/khan-janbaz?lang=ur
خان محمد خلیل 	/poets/khan-mohammad-khaleel?lang=ur
خان رضوان 	/poets/khan-rizwan?lang=ur
خنجر غازی پوری 	/poets/khanjar-ghazipuri?lang=ur
خاقان خاور 	/poets/khaqan-khavar?lang=ur
خار دہلوی 	/poets/khar-dehlavi?lang=ur
خاطر غزنوی 	/poets/khatir-ghaznavi?lang=ur
خواجہ جاوید اختر 	/poets/khawaja-javed-akhtar?lang=ur
خاور احمد 	/poets/khawar-ahmad?lang=ur
خاور لدھیانوی 	/poets/khawar-ludhianvi?lang=ur
خاور نقیب 	/poets/khawar-naqeeb?lang=ur
خاور نقوی 	/poets/khawar-naqvi?lang=ur
خاور رضوی 	/poets/khawar-rizvi?lang=ur
خیال امروہوی 	/poets/khayal-amrohvi?lang=ur
خضر برنی 	/poets/khizr-barni?lang=ur
خمارؔ بارہ بنکوی 	/poets/khumar-barabankavi?lang=ur
خمار میرزادہ 	/poets/khumar-pirzada?lang=ur
خمار قریشی 	/poets/khumar-qureshi?lang=ur
خرم خلیق 	/poets/khurram-khaleeq?lang=ur
خرم خرام صدیقی 	/poets/khurram-khiram-siddiqui?lang=ur
خورشید افسر بسوانی 	/poets/khursheed-afsar-baswani?lang=ur
خورشید احمد ملک 	/poets/khursheed-ahmad-malik?lang=ur
خورشید اکبر 	/poets/khursheed-akbar?lang=ur
خورشید بیگ ملیسوی 	/poets/khursheed-beg-malesvi?lang=ur
خورشید رضوی 	/poets/khursheed-rizvi?lang=ur
خورشید احمد جامی 	/poets/khurshid-ahmad-jami?lang=ur
خورشید اکرم 	/poets/khurshid-akram?lang=ur
خورشید ربانی 	/poets/khurshid-rabbani?lang=ur
خورشید سحر 	/poets/khurshid-sahar?lang=ur
خورشید طلب 	/poets/khurshid-talab?lang=ur
خورشید الاسلام 	/poets/khurshid-ul-islam?lang=ur
خوشبیر سنگھ شادؔ 	/poets/khushbir-singh-shaad?lang=ur
خوشی محمد ناظر 	/poets/khushi-mohammad-naazir?lang=ur
خواجہ ریاض الدین عطش 	/poets/khvaja-riyazuddin-atash?lang=ur
خواجہ امین الدین امین 	/poets/khwaja-aminuddin-ameen?lang=ur
خواجہ عزیز الحسن مجذوب 	/poets/khwaja-aziz-ul-hasan-majzuub?lang=ur
خواجہ محمود الحسن 	/poets/khwaja-mahmood-ul-hasan?lang=ur
خواجہ میر امانی 	/poets/khwaja-meer-amani?lang=ur
خواجہ میر دردؔ 	/poets/khwaja-meer-dard?lang=ur
خواجہ محمد وزیر لکھنوی 	/poets/khwaja-mohammad-vazeer-lakhnavi?lang=ur
خواجہ محمد زکریا 	/poets/khwaja-mohammad-zakariya?lang=ur
خواجہ ربانی 	/poets/khwaja-rabbani?lang=ur
خواجہ رضی حیدر 	/poets/khwaja-razi-haidar?lang=ur
خواجہ ساجد 	/poets/khwaja-sajid?lang=ur
کرتی رتن سنگھ 	/poets/kirti-ratan-singh?lang=ur
کشن کمار وقار 	/poets/kishan-kumaar-waqaar?lang=ur
کشور ناہید 	/poets/kishwar-naheed?lang=ur
کومل جوئیہ 	/poets/komal-joya?lang=ur
کرشن ادیب 	/poets/krishn-adeeb?lang=ur
کرشن بہاری نور 	/poets/krishn-bihari-noor?lang=ur
کرشن گوپال مغموم 	/poets/krishn-gopal-maghmum?lang=ur
کرشن مراری 	/poets/krishn-murari?lang=ur
کرشن کمار ناز 	/poets/krishna-kumar-naz?lang=ur
کرشن کمار طورؔ 	/poets/krishna-kumar-toor?lang=ur
کرشن موہن 	/poets/krishna-mohan?lang=ur
کلدیپ کمار 	/poets/kuldeep-kumar?lang=ur
کمار پاشی 	/poets/kumar-pashi?lang=ur
کمار وشواس 	/poets/kumar-vishwas?lang=ur
کنور بے چین 	/poets/kunwar-bechain?lang=ur
کنور اعجاز راجا 	/poets/kunwar-ejaz-raja?lang=ur
کنور مہیندر سنگھ بیدی سحر 	/poets/kunwar-mahendra-singh-bedi-sahar?lang=ur
لئیق عاجز 	/poets/laiq-aajiz?lang=ur
لئیق اکبر سحاب 	/poets/laiq-akbar-sahaab?lang=ur
لیث قریشی 	/poets/lais-quraishi?lang=ur
لال چند فلک 	/poets/lal-chand-falak?lang=ur
لالہ انوپ چند آفتاب پانی پتی 	/poets/lala-anoop-chand-aaftab-panipati?lang=ur
لالہ کانجی مل صبا 	/poets/lala-kanji-mil-saba?lang=ur
لالہ مادھو رام جوہر 	/poets/lala-madhav-ram-jauhar?lang=ur
لالہ ٹیکا رام 	/poets/lala-tika-ram?lang=ur
للن چودھری 	/poets/lalan-chaudhary?lang=ur
لتا حیا 	/poets/lata-haya?lang=ur
لطیف ساحل 	/poets/lateef-sahil?lang=ur
لکشمن شرما وحید 	/poets/laxman-sharma-vahid?lang=ur
لکشمی نارائن فارغ 	/poets/laxmi-narayan-farigh?lang=ur
لیاقت جعفری 	/poets/liaqat-jafri?lang=ur
لیاقت علی عاصم 	/poets/liyaqat-ali-aasim?lang=ur
 لطف الرحمن  	/poets/lutf-ur-rahman?lang=ur
لئیق عاجز 	/poets/laiq-aajiz?lang=ur
لئیق اکبر سحاب 	/poets/laiq-akbar-sahaab?lang=ur
لیث قریشی 	/poets/lais-quraishi?lang=ur
لال چند فلک 	/poets/lal-chand-falak?lang=ur
لالہ انوپ چند آفتاب پانی پتی 	/poets/lala-anoop-chand-aaftab-panipati?lang=ur
لالہ کانجی مل صبا 	/poets/lala-kanji-mil-saba?lang=ur
لالہ مادھو رام جوہر 	/poets/lala-madhav-ram-jauhar?lang=ur
لالہ ٹیکا رام 	/poets/lala-tika-ram?lang=ur
للن چودھری 	/poets/lalan-chaudhary?lang=ur
لتا حیا 	/poets/lata-haya?lang=ur
لطیف ساحل 	/poets/lateef-sahil?lang=ur
لکشمن شرما وحید 	/poets/laxman-sharma-vahid?lang=ur
لکشمی نارائن فارغ 	/poets/laxmi-narayan-farigh?lang=ur
لیاقت جعفری 	/poets/liaqat-jafri?lang=ur
لیاقت علی عاصم 	/poets/liyaqat-ali-aasim?lang=ur
 لطف الرحمن  	/poets/lutf-ur-rahman?lang=ur
ایم کوٹھیاوی راہی 	/poets/m-kothiyavi-rahi?lang=ur
ایم آر قاسمی 	/poets/m-r-qasmi?lang=ur
ایم اے قدیر 	/poets/m-a-qadeer?lang=ur
ماہر بلگرامی 	/poets/maahir-balgiraami?lang=ur
ماتم فضل محمد 	/poets/maatam-fazl-mohammad?lang=ur
مدن موہن دانش 	/poets/madan-mohan-danish?lang=ur
مدن پال 	/poets/madan-pal?lang=ur
مادھو اوانہ 	/poets/madhav-awana?lang=ur
مدھو گپتا 	/poets/madhu-gupta?lang=ur
مدھوکر جھا خوددار 	/poets/madhukar-jha-khuddar?lang=ur
مدھون رشی راج 	/poets/madhuvan-rishi-raj?lang=ur
ماہ لقا چنداؔ 	/poets/mah-laqa-chanda?lang=ur
ماہ طلعت زاہدی 	/poets/mah-talat-zahidi?lang=ur
مہراج سرکشن پرشاد شاد 	/poets/maharaj-sir-kishan-parashad-shad?lang=ur
مہاویر پرشاد انجم 	/poets/mahaveer-parshad-anjum?lang=ur
مہاویر اترانچلی 	/poets/mahaveer-uttaranchali?lang=ur
محبوب خزاں 	/poets/mahboob-khizan?lang=ur
محبوب ظفر 	/poets/mahboob-zafar?lang=ur
مہندر کمار ثانی 	/poets/mahender-kumar-sani?lang=ur
مہندر پرتاپ چاند 	/poets/mahendra-partap-chand?lang=ur
مہیندر سنگھ برق 	/poets/mahendra-singh-barq?lang=ur
مہر چند کوثر 	/poets/maher-chand-kausar?lang=ur
مہیش چندر نقش 	/poets/mahesh-chandra-naqsh?lang=ur
مہیش جانب 	/poets/mahesh-janib?lang=ur
محفوظ اثر 	/poets/mahfooz-asar?lang=ur
محفوظ الرحمان عادل 	/poets/mahfuzur-rahman-adil?lang=ur
ماہر آروی 	/poets/mahir-aarwi?lang=ur
ماہر عبدالحی 	/poets/mahir-abdul-hayee?lang=ur
ماہر الحمیدی 	/poets/mahir-al-hameedi?lang=ur
ماہر سیوہاروی 	/poets/mahir-sivharvi?lang=ur
ماہر القادری 	/poets/mahirul-qadri?lang=ur
محمود ایاز 	/poets/mahmood-ayaz?lang=ur
محمود اظہر 	/poets/mahmood-azhar?lang=ur
محمود بیگ ساز 	/poets/mahmood-beg-saaz?lang=ur
محمود غزنی 	/poets/mahmood-ghazni?lang=ur
محمود عشقی 	/poets/mahmood-ishqi?lang=ur
محمود خاور 	/poets/mahmood-khawer?lang=ur
محمود رائے بریلوی 	/poets/mahmood-rae-barelvi?lang=ur
محمود رحیم 	/poets/mahmood-rahim?lang=ur
محمود ثنا 	/poets/mahmood-sana?lang=ur
محمود سروش 	/poets/mahmood-sarosh?lang=ur
محمود شام 	/poets/mahmood-shaam?lang=ur
محمودہ  غازیہ 	/poets/mahmooda-gaziya?lang=ur
محمود الحسن 	/poets/mahmood-ul-hasan?lang=ur
محشر بدایونی 	/poets/mahshar-badayuni?lang=ur
محشر عنایتی 	/poets/mahshar-inayati?lang=ur
محشر کاظم حسین لکھنوی 	/poets/mahshar-kazim-husain-lakhnavi?lang=ur
محشر لکھنوی 	/poets/mahshar-lakhnavi?lang=ur
مہتاب عالم 	/poets/mahtab-alam?lang=ur
مہتاب حیدر نقوی 	/poets/mahtab-haider-naqvi?lang=ur
ایم کوٹھیاوی راہی 	/poets/m-kothiyavi-rahi?lang=ur
ایم آر قاسمی 	/poets/m-r-qasmi?lang=ur
ایم اے قدیر 	/poets/m-a-qadeer?lang=ur
ماہر بلگرامی 	/poets/maahir-balgiraami?lang=ur
ماتم فضل محمد 	/poets/maatam-fazl-mohammad?lang=ur
مدن موہن دانش 	/poets/madan-mohan-danish?lang=ur
مدن پال 	/poets/madan-pal?lang=ur
مادھو اوانہ 	/poets/madhav-awana?lang=ur
مدھو گپتا 	/poets/madhu-gupta?lang=ur
مدھوکر جھا خوددار 	/poets/madhukar-jha-khuddar?lang=ur
مدھون رشی راج 	/poets/madhuvan-rishi-raj?lang=ur
ماہ لقا چنداؔ 	/poets/mah-laqa-chanda?lang=ur
ماہ طلعت زاہدی 	/poets/mah-talat-zahidi?lang=ur
مہراج سرکشن پرشاد شاد 	/poets/maharaj-sir-kishan-parashad-shad?lang=ur
مہاویر پرشاد انجم 	/poets/mahaveer-parshad-anjum?lang=ur
مہاویر اترانچلی 	/poets/mahaveer-uttaranchali?lang=ur
محبوب خزاں 	/poets/mahboob-khizan?lang=ur
محبوب ظفر 	/poets/mahboob-zafar?lang=ur
مہندر کمار ثانی 	/poets/mahender-kumar-sani?lang=ur
مہندر پرتاپ چاند 	/poets/mahendra-partap-chand?lang=ur
مہیندر سنگھ برق 	/poets/mahendra-singh-barq?lang=ur
مہر چند کوثر 	/poets/maher-chand-kausar?lang=ur
مہیش چندر نقش 	/poets/mahesh-chandra-naqsh?lang=ur
مہیش جانب 	/poets/mahesh-janib?lang=ur
محفوظ اثر 	/poets/mahfooz-asar?lang=ur
محفوظ الرحمان عادل 	/poets/mahfuzur-rahman-adil?lang=ur
ماہر آروی 	/poets/mahir-aarwi?lang=ur
ماہر عبدالحی 	/poets/mahir-abdul-hayee?lang=ur
ماہر الحمیدی 	/poets/mahir-al-hameedi?lang=ur
ماہر سیوہاروی 	/poets/mahir-sivharvi?lang=ur
ماہر القادری 	/poets/mahirul-qadri?lang=ur
محمود ایاز 	/poets/mahmood-ayaz?lang=ur
محمود اظہر 	/poets/mahmood-azhar?lang=ur
محمود بیگ ساز 	/poets/mahmood-beg-saaz?lang=ur
محمود غزنی 	/poets/mahmood-ghazni?lang=ur
محمود عشقی 	/poets/mahmood-ishqi?lang=ur
محمود خاور 	/poets/mahmood-khawer?lang=ur
محمود رائے بریلوی 	/poets/mahmood-rae-barelvi?lang=ur
محمود رحیم 	/poets/mahmood-rahim?lang=ur
محمود ثنا 	/poets/mahmood-sana?lang=ur
محمود سروش 	/poets/mahmood-sarosh?lang=ur
محمود شام 	/poets/mahmood-shaam?lang=ur
محمودہ  غازیہ 	/poets/mahmooda-gaziya?lang=ur
محمود الحسن 	/poets/mahmood-ul-hasan?lang=ur
محشر بدایونی 	/poets/mahshar-badayuni?lang=ur
محشر عنایتی 	/poets/mahshar-inayati?lang=ur
محشر کاظم حسین لکھنوی 	/poets/mahshar-kazim-husain-lakhnavi?lang=ur
محشر لکھنوی 	/poets/mahshar-lakhnavi?lang=ur
مہتاب عالم 	/poets/mahtab-alam?lang=ur
مہتاب حیدر نقوی 	/poets/mahtab-haider-naqvi?lang=ur
مہتاب ظفر 	/poets/mahtab-zafar?lang=ur
محضر لکھنوی 	/poets/mahzar-lakhnavi?lang=ur
میکش اجمیری 	/poets/maikash-ajmeri?lang=ur
میکش اکبرآبادی 	/poets/maikash-akbarabadi?lang=ur
میکش بدایونی 	/poets/maikash-badayuni?lang=ur
میکش ناگپوری 	/poets/maikash-nag-puri?lang=ur
میمونہ عباس خان 	/poets/maimoona-abbas-khan?lang=ur
مجاز جے پوری 	/poets/majaz-jaipuri?lang=ur
مجید اختر 	/poets/majeed-akhtar?lang=ur
مجید امجد 	/poets/majeed-amjad?lang=ur
مجید لاہوری 	/poets/majeed-lahori?lang=ur
مجید میمن 	/poets/majeed-maiman?lang=ur
ماجد دیوبندی 	/poets/majid-deobandi?lang=ur
ماجد صدیقی 	/poets/majid-siddiqui?lang=ur
ماجد الباقری 	/poets/majid-ul-baqri?lang=ur
مجنوں گورکھپوری 	/poets/majnoon-gorakhpuri?lang=ur
مجروح سلطانپوری 	/poets/majrooh-sultanpuri?lang=ur
مکین احسن کلیم 	/poets/makeen-ahsan-kaleem?lang=ur
مخدومؔ محی الدین 	/poets/makhdoom-mohiuddin?lang=ur
مخدوم منور 	/poets/makhdoom-munawwar?lang=ur
مخمور دہلوی 	/poets/makhmoor-dehlvi?lang=ur
مخمور جالندھری 	/poets/makhmoor-jalandhari?lang=ur
مخمور کنور 	/poets/makhmoor-kunwar?lang=ur
مخمور سعیدی 	/poets/makhmoor-saeedi?lang=ur
ملک احسان 	/poets/malik-ehsan?lang=ur
ملکہ نسیم 	/poets/malika-naseem?lang=ur
ملک زادہ  جاوید 	/poets/malikzada-javed?lang=ur
ملک زادہ منظور احمد 	/poets/malikzada-manzoor-ahmad?lang=ur
ممنونؔ نظام الدین 	/poets/mamnoon-nizamuddin?lang=ur
ممتا تیواری 	/poets/mamta-tiwari?lang=ur
مانی جائسی 	/poets/mani-jayasi?lang=ur
منیش شکلا 	/poets/manish-shukla?lang=ur
منموہن تلخ 	/poets/manmohan-talkh?lang=ur
منّان بجنوری 	/poets/mannan-bijnori?lang=ur
منوہر لال ہادی 	/poets/manohar-lal-hadi?lang=ur
منوہر سہائے انور 	/poets/manohar-sahaye-anwar?lang=ur
منوج اظہر 	/poets/manoj-azhar?lang=ur
منصور آفاق 	/poets/mansoor-aafaque?lang=ur
منصور احمد 	/poets/mansoor-ahmad?lang=ur
منصور خوشتر 	/poets/mansoor-khushtar?lang=ur
منصور ملتانی 	/poets/mansoor-multani?lang=ur
منصور عثمانی 	/poets/mansoor-usmani?lang=ur
منصورہ احمد 	/poets/mansoora-ahmad?lang=ur
منظر ایوبی 	/poets/manzar-ayubi?lang=ur
منظر بھوپالی 	/poets/manzar-bhopali?lang=ur
منظر لکھنوی 	/poets/manzar-lakhnavi?lang=ur
منظر مفتی 	/poets/manzar-mufti?lang=ur
منظر نقوی 	/poets/manzar-naqvi?lang=ur
منظر سلیم 	/poets/manzar-saleem?lang=ur
منظر شہاب 	/poets/manzar-shahab?lang=ur
منظور احمد منظور 	/poets/manzoor-ahmad-manzoor?lang=ur
منظور علی راہی 	/poets/manzoor-ali-rahi?lang=ur
منظور عارف 	/poets/manzoor-arif?lang=ur
منظور دیپالپوری 	/poets/manzoor-depalpuri?lang=ur
منظور ہاشمی 	/poets/manzoor-hashmi?lang=ur
منظور حسین شور 	/poets/manzoor-husain-shor?lang=ur
منظور امکانی 	/poets/manzoor-imakni?lang=ur
مقبول عامر 	/poets/maqbool-aamir?lang=ur
مقبول حسین سید کرنل 	/poets/maqbool-husain-syed-karnal?lang=ur
مقبول نقش 	/poets/maqbool-naqsh?lang=ur
مقصود وفا 	/poets/maqsood-wafa?lang=ur
مراحب قاسمی 	/poets/marahib-qasmi?lang=ur
مراتب اختر 	/poets/maratib-akhtar?lang=ur
مردان علی خاں رانا 	/poets/mardan-ali-khan-rana?lang=ur
مردان صفی 	/poets/mardan-safi?lang=ur
مرغوب علی 	/poets/marghoob-ali?lang=ur
مرغوب اثر فاطمی 	/poets/marghoob-asar-fatmi?lang=ur
مرغوب حسن 	/poets/marghoob-hasan?lang=ur
معروف دہلوی 	/poets/maroof-dehlvi?lang=ur
معروف رائے بریلوی 	/poets/maroof-ray-barelvi?lang=ur
مریم ناز 	/poets/maryam-naz?lang=ur
مریم تسلیم کیانی 	/poets/maryam-tasleem-kiyani?lang=ur
مشکور حسین یاد 	/poets/mashkoor-husain-yaad?lang=ur
مشکور ممنون قنوجی 	/poets/mashkoor-mamnoon-qannauji?lang=ur
مسعود اختر جمال 	/poets/masood-akhtar-jamal?lang=ur
مسعود انور شفقی 	/poets/masood-anwar-shafaqi?lang=ur
مسعود حسن 	/poets/masood-hasan?lang=ur
مسعود حساس 	/poets/masood-hassas?lang=ur
مسعود میکش مراد آبادی 	/poets/masood-maikash-muradabadi?lang=ur
مسعود مرزا نیازی 	/poets/masood-mirza-niyazi?lang=ur
مسعود منور 	/poets/masood-munavvar?lang=ur
مسعود قریشی 	/poets/masood-qureshi?lang=ur
مسعودہ حیات 	/poets/masooda-hayat?lang=ur
معصوم شرقی 	/poets/masoom-sharqi?lang=ur
معصوم شیرازی 	/poets/masoom-sheerazi?lang=ur
مسرور انور 	/poets/masroor-anwar?lang=ur
مسعود حسین خاں 	/poets/masud-husain-khan?lang=ur
متین سروش 	/poets/mateen-sarosh?lang=ur
متین نیازی 	/poets/matin-niazi?lang=ur
موج فتح گڑھی 	/poets/mauj-fatehgarhi?lang=ur
مایا کھنّہ راجے بریلوی 	/poets/maya-khanna-raje-barelvi?lang=ur
مائل خیرآبادی  	/poets/mayal-khairabadi?lang=ur
مینک اوستھی 	/poets/mayank-awasthi?lang=ur
مذاق بدایونی 	/poets/mazaq-badayuni?lang=ur
مظہر عباس 	/poets/mazhar-abbas?lang=ur
مظہر امام 	/poets/mazhar-imam?lang=ur
مظہر مرزا جان جاناں 	/poets/mazhar-mirza-jaan-e-janaan?lang=ur
م حسن لطیفی 	/poets/meem-hasan-lateefi?lang=ur
مینا کماری 	/poets/meena-kumari?lang=ur
مینا نقوی 	/poets/meena-naqvi?lang=ur
مناکشی جی جی ویشا 	/poets/meenakshi-jijivisha?lang=ur
میر احمد نوید 	/poets/meer-ahmad-naved?lang=ur
میر علی اوسط رشک 	/poets/meer-ali-ausat-rashk?lang=ur
میر انیس 	/poets/meer-anees?lang=ur
میر اثر 	/poets/meer-asar?lang=ur
میر بشیر 	/poets/meer-basheer?lang=ur
میر حسن 	/poets/meer-hasan?lang=ur
میر کلو عرش 	/poets/meer-kallu-arsh?lang=ur
میر مہدی مجروح 	/poets/meer-mehdi-majrooh?lang=ur
میر محمد باقر حزیں 	/poets/meer-mohammad-baqar-hazin?lang=ur
میر محمد سلطان عاقل 	/poets/meer-mohammad-sultan-aaqil?lang=ur
میر محمدی بیدار 	/poets/meer-mohammadi-bedar?lang=ur
میر مستحسن خلیق 	/poets/meer-mustahsan-khaleeq?lang=ur
میر نقی علی خاں ثاقب 	/poets/meer-naqi-ali-khan-saqib?lang=ur
میر قمر الدین منت 	/poets/meer-qamruddin-mannat?lang=ur
میر سید نذیر حسین ناشاد 	/poets/meer-sayed-nazeer-husain-nashad?lang=ur
میر شمس الدین فقیر 	/poets/meer-shamsuddeen-faqeer?lang=ur
میر سوز 	/poets/meer-soz?lang=ur
میر طاہر علی طاہر فرخ آبادی 	/poets/meer-tahir-ali-tahir-farrukhabadi?lang=ur
میر یٰسین علی خاں 	/poets/meer-yaseen-ali-khan?lang=ur
میرضیا الدین ضیا 	/poets/meer-ziauddin-zia?lang=ur
میراجی 	/poets/meeraji?lang=ur
میراں ہاشمی 	/poets/meeran-hashmi?lang=ur
مرزا جواں بخت جہاں دار 	/poets/meerza-jawan-bakht-jahandar?lang=ur
میگی آسنانی 	/poets/megi-asnani?lang=ur
محبوب عزمی 	/poets/mehboob-azmi?lang=ur
محبوب راہی 	/poets/mehboob-rahi?lang=ur
مہدی جعفر 	/poets/mehdi-jafar?lang=ur
مہدی پرتاپ گڑھی 	/poets/mehdi-pratapgarhi?lang=ur
محشر آفریدی 	/poets/mehshar-afridi?lang=ur
محور نوری 	/poets/mehwar-noori?lang=ur
میلہ رام وفاؔ 	/poets/mela-ram-wafa?lang=ur
معراج فیض آبادی 	/poets/meraj-faizabadi?lang=ur
معراج لکھنوی 	/poets/meraj-lakhnavi?lang=ur
معراج نقوی 	/poets/meraj-naqvi?lang=ur
مدحت الاختر 	/poets/midhat-ul-akhtar?lang=ur
میر شیر علی افسوس 	/poets/miir-sher-alii-afsos?lang=ur
مینو بخشی 	/poets/minu-bakshi?lang=ur
میر سجاد 	/poets/mir-sajjad?lang=ur
میر تقی میر 	/miiriyaat?lang=ur
مرزا عبدالغفور گورگانی ارشد 	/poets/mirza-abdul-ghafoor-gorgani-arshad?lang=ur
مرزا علی لطف 	/poets/mirza-ali-lutf?lang=ur
میرزا الطاف حسین عالم لکھنوی 	/poets/mirza-altaf-husain-alim-lucknowi?lang=ur
مرزا آسمان جاہ انجم 	/poets/mirza-asman-jah-anjum?lang=ur
مرزا اطہر ضیا 	/poets/mirza-athar-zia?lang=ur
مرزا اظفری 	/poets/mirza-azfari?lang=ur
مرزا غالب 	/poets/mirza-ghalib?lang=ur
مرزا ہادی رسوا 	/poets/mirza-hadi-ruswa?lang=ur
مرزا حیدر علی حیران 	/poets/mirza-haider-ali-hairan?lang=ur
مرزا حسین علی محنت 	/poets/mirza-husain-ali-mehnat?lang=ur
مرزا ابراہیم بیگ مقتول 	/poets/mirza-ibraheem-beg-maqtool?lang=ur
مرزا محمود سرحدی 	/poets/mirza-mahmood-sarhadi?lang=ur
مرزا مسیتابیگ منتہی 	/poets/mirza-maseeta-beg-muntahi?lang=ur
مرزا مائل دہلوی 	/poets/mirza-mayal-dehlvi?lang=ur
مرزا محمد نیر 	/poets/mirza-mohammad-nayar?lang=ur
مرزا محمد تقی ہوسؔ 	/poets/mirza-mohammad-taqi-hawas?lang=ur
مرزا نعیم بیگ جوان 	/poets/mirza-naeem-beg-jawan?lang=ur
مرزا قادر بخش صابر دہلوی 	/poets/mirza-qadir-bakhsh-sabir-dehlavi?lang=ur
مرزا رحیم الدین حیا 	/poets/mirza-rahimuddin-haya?lang=ur
مرزارضا برق ؔ 	/poets/mirza-raza-barq?lang=ur
مرزا رضا قلی آشفتہ 	/poets/mirza-raza-quli-ashufta?lang=ur
مرزا شوقؔ  لکھنوی 	/poets/mirza-shauq-lakhnavi?lang=ur
میثم علی آغا 	/poets/misam-ali-aagha?lang=ur
مصداق اعظمی 	/poets/misdaque-azmi?lang=ur
مسکین شاہ 	/poets/miskeen-shah?lang=ur
میاں داد خاں سیاح 	/poets/miyan-dad-khan-sayyah?lang=ur
میاں حاجی تجلی 	/poets/miyan-haji-tajalli?lang=ur
میاں نورالاسلام منتظر 	/poets/miyan-noor-ul-islam-muntazir?lang=ur
مغیث الدین فریدی 	/poets/moghisuddin-fareedi?lang=ur
محمد نسیم قریشی 	/poets/mohaamad-nasim-qureshi?lang=ur
محمد اعظم 	/poets/mohammad-aazam?lang=ur
محمد عباس سفیر 	/poets/mohammad-abbas-safiir?lang=ur
محمد عبد الحمید صدیقی نظر لکھنوی 	/poets/mohammad-abdul-hameed-siddiqi-nazar-lakhnawi?lang=ur
محمد عابد علی عابد 	/poets/mohammad-abid-ali-abid?lang=ur
محمد افسر ساجد 	/poets/mohammad-afsar-sajid?lang=ur
محمد آفتاب احمد ثاقب 	/poets/mohammad-aftab-ahmad-saqib?lang=ur
محمد احمد 	/poets/mohammad-ahmad?lang=ur
محمد احمد رمز 	/poets/mohammad-ahmad-ramz?lang=ur
محمد اجمل نیازی 	/poets/mohammad-ajmal-niyazi?lang=ur
محمد اکبر نیازی 	/poets/mohammad-akbar-niyazi?lang=ur
محمد علی اثر 	/poets/mohammad-ali-asar?lang=ur
محمد علی جوہرؔ 	/poets/mohammad-ali-jauhar?lang=ur
محمد علی خاں رشکی 	/poets/mohammad-ali-khan-rashki?lang=ur
محمد علی منظر 	/poets/mohammad-ali-manzar?lang=ur
محمد علی موج 	/poets/mohammad-ali-mauj?lang=ur
محمد علی ساحل 	/poets/mohammad-ali-sahil?lang=ur
محمد علی تشنہ 	/poets/mohammad-ali-tishna?lang=ur
محمد علوی 	/poets/mohammad-alvi?lang=ur
محمد امان نثار 	/poets/mohammad-amaan-nisar?lang=ur
محمد امیر اعظم قریشی 	/poets/mohammad-amir-azam-quraishi?lang=ur
محمد انور  خالد 	/poets/mohammad-anvar-khalid?lang=ur
محمد اسلم خان اسلم  	/poets/mohammad-aslam-khan-aslam?lang=ur
محمد عظیم 	/poets/mohammad-azeem?lang=ur
محمد اظہر شمس 	/poets/mohammad-azhar-shams?lang=ur
محمد دین تاثیر 	/poets/mohammad-deen-taseer?lang=ur
محمد فیض اللہ فیض 	/poets/mohammad-faizullah-faiz?lang=ur
محمد فخرالحق نوری 	/poets/mohammad-fakhrul-haq-noori?lang=ur
محمد فیروز شاہ 	/poets/mohammad-firoz-shah?lang=ur
محمد حنیف رامے 	/poets/mohammad-haneef-rame?lang=ur
محمد حازم حسان 	/poets/mohammad-hazim-hassan?lang=ur
محمد عیسیٰ تنہا 	/poets/mohammad-isa-tanha?lang=ur
محمد اظہار الحق 	/poets/mohammad-izhar-ul-haq?lang=ur
محمد خالد 	/poets/mohammad-khalid?lang=ur
محمد منشاء الرحمن خاں منشاء 	/poets/mohammad-mansha-ur-rahman-khan-mansha?lang=ur
محمد مبشر میو 	/poets/mohammad-mubashshir-mayo?lang=ur
محمد مختار علی 	/poets/mohammad-mukhtar-ali?lang=ur
محمد مستحسن جامی 	/poets/mohammad-mustahsan-jami?lang=ur
محمد نعیم اللہ خیالی 	/poets/mohammad-naeemullah-khayali?lang=ur
محمد نقی رضوی عصر 	/poets/mohammad-naqi-rizvi-asr?lang=ur
محمد نوید مرزا 	/poets/mohammad-naved-mirza?lang=ur
محمد اسامہ خاکی 	/poets/mohammad-osama-khaki?lang=ur
محمد صادق قمر 	/poets/mohammad-sadiq-qamar?lang=ur
محمد صادق ضیا 	/poets/mohammad-sadiq-zia?lang=ur
محمد سجاد مرزا 	/poets/mohammad-sajjad-mirza?lang=ur
محمد سلیم ساگر 	/poets/mohammad-saleem-sagar?lang=ur
محمد سلیم طاہر 	/poets/mohammad-saleem-tahir?lang=ur
محمد سلیم الرحمٰن 	/poets/mohammad-saleemur-rahman?lang=ur
محمد سالم 	/poets/mohammad-salim?lang=ur
محمد شہباز اکمل 	/poets/mohammad-shahbaz-akmal?lang=ur
محمد صدیق صائب ٹونکی 	/poets/mohammad-siddiq-saib-tonki?lang=ur
محمد تنویرالزماں 	/poets/mohammad-tanviruzzaman?lang=ur
محمد عثمان عارف 	/poets/mohammad-usmaan-arif?lang=ur
محمد ولایت اللہ 	/poets/mohammad-wilayatullah?lang=ur
محمد یعقوب آسی 	/poets/mohammad-yaqoob-aasi?lang=ur
محمد یار خاکسار 	/poets/mohammad-yar-khaksar?lang=ur
محمد علی خاں ناظم رامپوری 	/poets/mohammad-yusuf-ali-khan-nazim-rampuri?lang=ur
محمد یوسف پاپا 	/poets/mohammad-yusuf-papa?lang=ur
محمد یوسف راسخ 	/poets/mohammad-yusuf-rasikh?lang=ur
محمد زکریا خان 	/poets/mohammad-zakariyya-khan?lang=ur
محمد نبی خاں جمال سویدا 	/poets/mohammed-nabi-khan-jamal-soveda?lang=ur
موہن جاودانی 	/poets/mohan-javidani?lang=ur
موہن سیرت اجمیری 	/poets/mohan-seerat-ajmeri?lang=ur
موہن سنگھ اوبے رائے دیوانہ 	/poets/mohan-singh-oberoi-deewana?lang=ur
محیط اسماعیل 	/poets/moheet-ismaeel?lang=ur
محسن آفتاب کیلاپوری 	/poets/mohsin-aftab-kelapuri?lang=ur
محسن اسرار 	/poets/mohsin-asrar?lang=ur
محسنؔ بھوپالی 	/poets/mohsin-bhopali?lang=ur
محسن چنگیزی 	/poets/mohsin-changezi?lang=ur
محسن احسان 	/poets/mohsin-ehsan?lang=ur
محسن جلگانوی 	/poets/mohsin-jalganvi?lang=ur
محسن نقوی 	/poets/mohsin-naqvi?lang=ur
محسن شیخ 	/poets/mohsin-shaikh?lang=ur
محسن شکیل 	/poets/mohsin-shakeel?lang=ur
محسن زیدی 	/poets/mohsin-zaidi?lang=ur
معید رشیدی 	/poets/moid-rashidi?lang=ur
معین احسن جذبی 	/poets/moin-ahsan-jazbi?lang=ur
معین نجمی 	/poets/moin-nizami?lang=ur
معین نظامی 	/poets/moin-nizaamii?lang=ur
معین شاداب 	/poets/moin-shadab?lang=ur
معین تابش 	/poets/moin-tabish?lang=ur
مومن خاں مومن 	/poets/momin-khan-momin?lang=ur
مونی گوپال تپش 	/poets/moni-gopal-tapish?lang=ur
مونیکا شرما سارتھی 	/poets/monika-sharma-sarthi?lang=ur
مونیکا سنگھ 	/poets/monika-singh?lang=ur
موسیٰ رضا 	/poets/moosa-raza?lang=ur
مبارک انصاری 	/poets/mubarak-ansari?lang=ur
مبارک عظیم آبادی 	/poets/mubarak-azimabadi?lang=ur
مبارک حیدر 	/poets/mubarak-haider?lang=ur
مبارک شمیم 	/poets/mubarak-shamim?lang=ur
مبشر علی زیدی 	/authors/mubashshir-ali-zaidi?lang=ur
مبشر سعید 	/poets/mubashshir-saeed?lang=ur
مبین مرزا 	/poets/mubeen-mirza?lang=ur
مفتی صدرالدین آزردہ 	/poets/mufti-sadruddin-aazurda?lang=ur
مغل فاروق پرواز 	/poets/mughal-farooq-parwaz?lang=ur
مغنی تبسم 	/poets/mughni-tabassum?lang=ur
محمد ایوب ذوقی 	/poets/muhammad-ayyub-zauqi?lang=ur
محب عارفی 	/poets/muhib-aarfi?lang=ur
محب کوثر 	/poets/muhib-kausar?lang=ur
محی الدین فوق 	/poets/muhiuddin-fauq?lang=ur
محی الدین عرفان 	/poets/muhiuddin-irfan?lang=ur
مجاہد فراز 	/poets/mujahid-faraaz?lang=ur
مجیب ایمان 	/poets/mujeeb-iman?lang=ur
مجیب خیر آبادی 	/poets/mujeeb-khairabadi?lang=ur
مجیب ظفر انوار حمیدی 	/poets/mujeeb-zafar-anwar-hameedi?lang=ur
مکیش عالم 	/poets/mukesh-alam?lang=ur
مخلص وجدانی 	/poets/mukhlis-wajdani?lang=ur
مختار احمد کوثر 	/poets/mukhtar-ahmad-kausar?lang=ur
مختار ہاشمی 	/poets/mukhtar-hashmi?lang=ur
مختار جاوید 	/poets/mukhtar-javed?lang=ur
مختار شمیم 	/poets/mukhtar-shameem?lang=ur
مختار صدیقی 	/poets/mukhtar-siddiqui?lang=ur
ممتاز احمد خاں خوشتر کھنڈوی 	/poets/mumtaz-ahmad-khan-khushtar?lang=ur
ممتاز اطہر 	/poets/mumtaz-athar?lang=ur
ممتاز گورمانی 	/poets/mumtaz-gurmani?lang=ur
ممتاز کنول 	/poets/mumtaz-kanwal?lang=ur
ممتاز ملک 	/poets/mumtaz-malik?lang=ur
ممتاز مضی 	/poets/mumtaz-mazi?lang=ur
ممتاز میرزا 	/poets/mumtaz-mirza?lang=ur
ممتاز نسیم 	/poets/mumtaz-naseem?lang=ur
ممتاز راشد 	/poets/mumtaz-rashid?lang=ur
منور خان غافل 	/poets/munawar-khan-ghafil?lang=ur
منور عزیز 	/poets/munawwar-aziz?lang=ur
منور ہاشمی 	/poets/munawwar-hashmi?lang=ur
منور جمیل 	/poets/munawwar-jameel?lang=ur
منور لکھنوی 	/poets/munawwar-lakhnavi?lang=ur
منور رانا 	/poets/munawwar-rana?lang=ur
منیب الرحمن 	/poets/muneebur-rahman?lang=ur
منیر احمد فردوس 	/poets/muneer-ahmad-firdaus?lang=ur
منیر احمد جامی 	/poets/muneer-ahmad-jami?lang=ur
منیر احمد منیر دہلوی 	/poets/muneer-ahmad-muneer-dehlvi?lang=ur
منیر فاطمی 	/poets/muneer-fatmi?lang=ur
منیر نیازی 	/poets/muneer-niyazi?lang=ur
منیر سیفی 	/poets/muneer-saifi?lang=ur
منیر سیفی 	/poets/muneer-saifi-1?lang=ur
منیرؔ  شکوہ آبادی 	/poets/muneer-shikohabadi?lang=ur
منیرالدین سحر سعیدی 	/poets/muneeruddin-sahar-saeedi?lang=ur
منیر ارمان نسیمی 	/authors/munir-arman-nasimi?lang=ur
منشی بنواری لال شعلہ 	/poets/munshi-banwari-lal-shola?lang=ur
منشی بہاری لال مشتاق دہلوی 	/poets/munshi-bihari-lal-mushtaq-dehlwi?lang=ur
منشی دیبی پرشاد سحر بدایونی 	/poets/munshi-debi-parshad-sahar-badayuni?lang=ur
منشی جوالا پرشاد برق 	/poets/munshi-jwala-parshad-barq?lang=ur
منشی خیراتی لال شگفتہ 	/poets/munshi-khairati-laal-shagufta?lang=ur
منشی نوبت رائے نظر لکھنوی 	/poets/munshi-naubat-rai-nazar-lakhnavi?lang=ur
منتظر فیروز آبادی 	/poets/muntazir-firozabadi?lang=ur
منتظر لکھنوی 	/poets/muntazir-lakhnavi?lang=ur
مقدس ملک  new	/poets/muqaddas-malik?lang=ur
مقیم احسان کلیمؔ 	/poets/muqeem-ehsan-kaleem?lang=ur
مقسط ندیم 	/poets/muqsit-nadeem?lang=ur
مرلی دھر شاد 	/poets/murli-dhar-shad?lang=ur
مرلی دھر شرما طالب 	/poets/murlidhar-sharma-talib?lang=ur
مرتضی علی شاد 	/poets/murtaza-ali-shad?lang=ur
مرتضیٰ برلاس 	/poets/murtaza-birlas?lang=ur
مسرت ہاشمی 	/poets/musarrat-hashmi?lang=ur
مصور فیروزپوری 	/poets/musavvir-firozpuri?lang=ur
مصور سبزواری 	/poets/musavvir-sabzwari?lang=ur
مصحف اقبال توصیفی 	/poets/mushaf-iqbal-tausifi?lang=ur
مصحفی غلام ہمدانی 	/poets/mushafi-ghulam-hamdani?lang=ur
مشفق خواجہ  	/poets/mushfiq-khwaja?lang=ur
مشیر جھنجھانوی 	/poets/mushir-jhanjhanvi?lang=ur
مشتاق آذر فریدی 	/poets/mushtaq-aazar-fareedi?lang=ur
مشتاق احمد نوری 	/poets/mushtaq-ahmad-noori?lang=ur
مشتاق عاجز 	/poets/mushtaq-ajiz?lang=ur
مشتاق علی شاھد 	/poets/mushtaq-ali-shahid?lang=ur
مشتاق انجم 	/poets/mushtaq-anjum?lang=ur
مشتاق نقوی 	/poets/mushtaq-naqvi?lang=ur
مشتاق صدف 	/poets/mushtaq-sadaf?lang=ur
مشتاق شاد 	/poets/mushtaq-shad?lang=ur
مشتاق سنگھ 	/poets/mushtaq-singh?lang=ur
مسلم انصاری 	/poets/muslim-ansari?lang=ur
مسلم سلیم 	/poets/muslim-saleem?lang=ur
مسلم شمیم 	/poets/muslim-shameem?lang=ur
مصطفیٰ ارباب 	/poets/mustafa-arbab?lang=ur
مصطفی شہاب 	/poets/mustafa-shahab?lang=ur
مصطفی زیدی 	/poets/mustafa-zaidi?lang=ur
مستحسن خیال 	/poets/mustahsin-khayal?lang=ur
مطرب نظامی 	/poets/mutrib-nizami?lang=ur
مظفر ابدالی  	/poets/muzaffar-abdali?lang=ur
مظفر احمد مظفر 	/poets/muzaffar-ahmad-muzaffar?lang=ur
مظفر علی اسیر 	/poets/muzaffar-ali-aseer?lang=ur
مظفر علی سید 	/poets/muzaffar-ali-syed?lang=ur
مظفر بخاری 	/poets/muzaffar-bukhari?lang=ur
مظفر حنفی 	/poets/muzaffar-hanfi?lang=ur
مظفر ایرج 	/poets/muzaffar-iraj?lang=ur
مظفر ممتاز 	/poets/muzaffar-mumtaz?lang=ur
مظفر رزمی 	/poets/muzaffar-razmi?lang=ur
مظفر شکوہ 	/poets/muzaffar-shikoh?lang=ur
مظفر وارثی 	/poets/muzaffar-warsi?lang=ur
مزمل حسین چیما 	/poets/muzammil-husain-cheema?lang=ur
مژدم خان 	/poets/muzdam-khan?lang=ur
مضطر حیدری 	/poets/muztar-haidri?lang=ur
مضطر خیرآبادی 	/poets/muztar-khairabadi?lang=ur
ناز مرادآبادی 	/poets/naaz-muradabadi?lang=ur
نبیل احمد نبیل 	/poets/nabeel-ahmad-nabeel?lang=ur
ندیم احمد 	/poets/nadeem-ahmad?lang=ur
ندیم بھابھہ 	/poets/nadeem-bhabha?lang=ur
ندیم فرخ 	/poets/nadeem-farrukh?lang=ur
ندیم فاضلی 	/poets/nadeem-fazli?lang=ur
ندیم گویائی 	/poets/nadeem-goyai?lang=ur
ندیم گلانی 	/poets/nadeem-gullani?lang=ur
ندیم ماہر 	/poets/nadeem-mahir?lang=ur
ندیم صدیقی 	/poets/nadeem-siddiqui?lang=ur
ندیم سرسوی 	/poets/nadeem-sirsivi?lang=ur
نادم ندیم 	/poets/nadim-nadeem?lang=ur
نادر عریض 	/poets/nadir-areez?lang=ur
نادر کاکوری 	/poets/nadir-kakorvi?lang=ur
نادر لکھنوی 	/poets/nadir-lakhnavi?lang=ur
نادر شاہجہاں پوری  	/poets/nadir-shahjahanpuri?lang=ur
نادر صدیقی 	/poets/nadir-siddiqui?lang=ur
نادیہ عنبر لودھی 	/poets/nadiya-ambar-lodhi?lang=ur
نعیم اختر 	/poets/naeem-akhtar?lang=ur
نغیم اختر خادمی 	/poets/naeem-akhtar-khadimi?lang=ur
نعیم گیلانی 	/poets/naeem-gilani?lang=ur
نعیم رضا بھٹی 	/poets/naeem-raza-bhatti?lang=ur
نعیم سرمد 	/poets/naeem-sarmad?lang=ur
نعیم ضرار احمد 	/poets/naeem-zarrar-ahmad?lang=ur
نفس انبالوی 	/poets/nafas-ambalvi?lang=ur
نفیر سرمدی 	/poets/nafeer-sarmadi?lang=ur
ناہید کوثر 	/poets/naheed-kausar?lang=ur
ناہید ورک 	/poets/naheed-virk?lang=ur
ناہید قمر 	/poets/nahid-qamar?lang=ur
ناہید قاسمی 	/poets/nahid-qasmi?lang=ur
ناہید رانا  	/poets/nahid-rana?lang=ur
نعیم صدیقی 	/poets/naim-siddiqi?lang=ur
نینا عادل 	/poets/naina-adil?lang=ur
نجیب احمد 	/poets/najeeb-ahmad?lang=ur
نجیب رامش 	/poets/najeeb-ramish?lang=ur
نجیبہ عارف 	/poets/najeeba-arif?lang=ur
ناجی شاکر 	/poets/naji-shakir?lang=ur
نجم آفندی 	/poets/najm-aafandi?lang=ur
نجمہ خان 	/poets/najma-khan?lang=ur
نجمہ شاہین کھوسہ 	/poets/najma-shaheen-khosa?lang=ur
نجمی صدیقی 	/poets/najmi-siddiqui?lang=ur
نجم الثاقب 	/poets/najmus-saqib?lang=ur
نخشب جارچوی 	/poets/nakhshab-jaarchawi?lang=ur
نامی انصاری 	/poets/nami-ansari?lang=ur
نقاش عابدی 	/poets/naqqash-abidi?lang=ur
نقاش کاظمی 	/poets/naqqash-kazmi?lang=ur
نقش لائل پوری 	/poets/naqsh-layalpuri?lang=ur
نریش کمار درد 	/poets/naresh-kumar-dard?lang=ur
نریش کمار شاد 	/poets/naresh-kumar-shad?lang=ur
نرجس افروز زیدی 	/poets/narjis-afroz-zaidi?lang=ur
ناز مرادآبادی 	/poets/naaz-muradabadi?lang=ur
نبیل احمد نبیل 	/poets/nabeel-ahmad-nabeel?lang=ur
ندیم احمد 	/poets/nadeem-ahmad?lang=ur
ندیم بھابھہ 	/poets/nadeem-bhabha?lang=ur
ندیم فرخ 	/poets/nadeem-farrukh?lang=ur
ندیم فاضلی 	/poets/nadeem-fazli?lang=ur
ندیم گویائی 	/poets/nadeem-goyai?lang=ur
ندیم گلانی 	/poets/nadeem-gullani?lang=ur
ندیم ماہر 	/poets/nadeem-mahir?lang=ur
ندیم صدیقی 	/poets/nadeem-siddiqui?lang=ur
ندیم سرسوی 	/poets/nadeem-sirsivi?lang=ur
نادم ندیم 	/poets/nadim-nadeem?lang=ur
نادر عریض 	/poets/nadir-areez?lang=ur
نادر کاکوری 	/poets/nadir-kakorvi?lang=ur
نادر لکھنوی 	/poets/nadir-lakhnavi?lang=ur
نادر شاہجہاں پوری  	/poets/nadir-shahjahanpuri?lang=ur
نادر صدیقی 	/poets/nadir-siddiqui?lang=ur
نادیہ عنبر لودھی 	/poets/nadiya-ambar-lodhi?lang=ur
نعیم اختر 	/poets/naeem-akhtar?lang=ur
نغیم اختر خادمی 	/poets/naeem-akhtar-khadimi?lang=ur
نعیم گیلانی 	/poets/naeem-gilani?lang=ur
نعیم رضا بھٹی 	/poets/naeem-raza-bhatti?lang=ur
نعیم سرمد 	/poets/naeem-sarmad?lang=ur
نعیم ضرار احمد 	/poets/naeem-zarrar-ahmad?lang=ur
نفس انبالوی 	/poets/nafas-ambalvi?lang=ur
نفیر سرمدی 	/poets/nafeer-sarmadi?lang=ur
ناہید کوثر 	/poets/naheed-kausar?lang=ur
ناہید ورک 	/poets/naheed-virk?lang=ur
ناہید قمر 	/poets/nahid-qamar?lang=ur
ناہید قاسمی 	/poets/nahid-qasmi?lang=ur
ناہید رانا  	/poets/nahid-rana?lang=ur
نعیم صدیقی 	/poets/naim-siddiqi?lang=ur
نینا عادل 	/poets/naina-adil?lang=ur
نجیب احمد 	/poets/najeeb-ahmad?lang=ur
نجیب رامش 	/poets/najeeb-ramish?lang=ur
نجیبہ عارف 	/poets/najeeba-arif?lang=ur
ناجی شاکر 	/poets/naji-shakir?lang=ur
نجم آفندی 	/poets/najm-aafandi?lang=ur
نجمہ خان 	/poets/najma-khan?lang=ur
نجمہ شاہین کھوسہ 	/poets/najma-shaheen-khosa?lang=ur
نجمی صدیقی 	/poets/najmi-siddiqui?lang=ur
نجم الثاقب 	/poets/najmus-saqib?lang=ur
نخشب جارچوی 	/poets/nakhshab-jaarchawi?lang=ur
نامی انصاری 	/poets/nami-ansari?lang=ur
نقاش عابدی 	/poets/naqqash-abidi?lang=ur
نقاش کاظمی 	/poets/naqqash-kazmi?lang=ur
نقش لائل پوری 	/poets/naqsh-layalpuri?lang=ur
نریش کمار درد 	/poets/naresh-kumar-dard?lang=ur
نریش کمار شاد 	/poets/naresh-kumar-shad?lang=ur
نرجس افروز زیدی 	/poets/narjis-afroz-zaidi?lang=ur
نسیم عباسی 	/poets/naseem-abbasi?lang=ur
نسیم احمد نسیم 	/poets/naseem-ahmad-naseem?lang=ur
نسیم انصاری 	/poets/naseem-ansari?lang=ur
نسیم بھرتپوری 	/poets/naseem-bharat-puri?lang=ur
نسیم دہلوی 	/poets/naseem-dehlvi?lang=ur
نسیم نازش 	/poets/naseem-nazish?lang=ur
نسیم نکہت 	/poets/naseem-nikhat?lang=ur
نسیم نور محلی 	/poets/naseem-noor-mahali?lang=ur
نسیم سحر 	/poets/naseem-sahar?lang=ur
نسیم سائلپوری 	/poets/naseem-sailpuri?lang=ur
نسیم شاہجہانپوری 	/poets/naseem-shahjahanpuri?lang=ur
نسیم شیخ 	/poets/naseem-shekh?lang=ur
نسیم صدیقی 	/poets/naseem-siddiqi?lang=ur
نسیم سید 	/poets/naseem-syed?lang=ur
نصیر احمد ناصر 	/poets/naseer-ahmad-nasir?lang=ur
نصیر آرزو 	/poets/naseer-arzoo?lang=ur
نصیر کوٹی 	/poets/naseer-koti?lang=ur
نصیر پرواز 	/poets/naseer-parwaz?lang=ur
نصیر ترابی 	/poets/naseer-turabi?lang=ur
ناصر الدین 	/poets/naseeruddin?lang=ur
ناشر نقوی 	/poets/nashir-naqvi?lang=ur
نشتر امروہوی 	/poets/nashtar-amrohvi?lang=ur
نشتر خانقاہی 	/poets/nashtar-khaanqahi?lang=ur
نسیم میسوری 	/poets/nasim-maysori?lang=ur
ناصر علی سید 	/poets/nasir-ali-syed?lang=ur
ناصر امروہوی 	/poets/nasir-amrohvi?lang=ur
ناصر عقیل 	/poets/nasir-aqeel?lang=ur
ناصر بلوچ 	/poets/nasir-baluch?lang=ur
ناصر بشیر 	/poets/nasir-basheer?lang=ur
ناصر چودھری 	/poets/nasir-chaudhri?lang=ur
ناصر جونپوری 	/poets/nasir-jaunpuri?lang=ur
ناصر کاظمی 	/poets/nasir-kazmi?lang=ur
ناصر راؤ 	/poets/nasir-rao?lang=ur
ناصر شہزاد 	/poets/nasir-shahzad?lang=ur
ناصر زیدی 	/poets/nasir-zaidi?lang=ur
نصر غزالی 	/poets/nasr-ghazali?lang=ur
نسرین انجم بھٹی 	/poets/nasreen-anjum-bhatti?lang=ur
نسرین انجم سیٹھی 	/poets/nasreen-anjum-sethi?lang=ur
نسرین نقاش 	/poets/nasreen-naqqash?lang=ur
ناطق گلاوٹھی 	/poets/natiq-gulavthi?lang=ur
ناطقؔ لکھنوی 	/poets/natiq-lakhnavi?lang=ur
نوبہار صابر 	/poets/nau-bahar-sabir?lang=ur
نوفل آریہ 	/poets/naufil-arya?lang=ur
نوشاد احمد کریمی 	/poets/naushad-ahmad-kareemi?lang=ur
نوشاد علی 	/poets/naushad-ali?lang=ur
نواب محمد یار خاں امیر 	/poets/navab-mohammad-yar-khan-ameer?lang=ur
نوید رضا 	/poets/naved-raza?lang=ur
نوین سی چترویدی 	/poets/navin-c-chaturvedi?lang=ur
نونیت شرما 	/poets/navneet-sharma?lang=ur
نواب احسن 	/poets/nawab-ahsan?lang=ur
نواب معظم جاہ شجیع 	/poets/nawab-moazzam-jah-shaji?lang=ur
نواب شاہ آبادی 	/poets/nawab-shahabadi?lang=ur
نواب شاہجہاں بیگم شاہجہاں 	/poets/nawab-shahjahan-begum-shahjahan?lang=ur
نواب سلیمان شکوہ 	/poets/nawab-sulaiman-shikoh?lang=ur
نواب ضیاالدین خاں رخشاں 	/poets/nawab-ziauddin-khan-rakhshaan?lang=ur
نواز عصیمی 	/poets/nawaz-asimi?lang=ur
نواز دیوبندی 	/poets/nawaz-deobandi?lang=ur
نوید ملک 	/poets/nawed-malik?lang=ur
نایاب 	/poets/nayab?lang=ur
نین سکھ 	/poets/nayan-sukh?lang=ur
نیرآثمی 	/poets/nayyar-aasmi?lang=ur
نیر قریشی گنگوہی 	/poets/nayyar-qureshi-gangohi?lang=ur
نیر سلطانپوری 	/poets/nayyar-sultanpuri?lang=ur
نیر واسطی 	/poets/nayyar-wasti?lang=ur
ناز بٹ 	/poets/naz-butt?lang=ur
ناز لائلپوری 	/poets/naz-layalpuri?lang=ur
ناز خیالوی 	/poets/naz-naz-khialvi?lang=ur
ناز قادری 	/poets/naz-qadri?lang=ur
نظر برنی 	/poets/nazar-barni?lang=ur
نظر حیدرآبادی 	/poets/nazar-hyderabadi?lang=ur
نذر جاوید 	/poets/nazar-javed?lang=ur
نظر کانپوری 	/poets/nazar-kanpuri?lang=ur
نظر صدیقی 	/poets/nazar-siddiqui?lang=ur
نذیر احمد ناجی 	/poets/nazeer-ahmad-naji?lang=ur
نظیر اکبرآبادی 	/poets/nazeer-akbarabadi?lang=ur
نذیر آزاد 	/poets/nazeer-azad?lang=ur
نظیر باقری 	/poets/nazeer-baaqri?lang=ur
نذیر بنارسی 	/poets/nazeer-banarasi?lang=ur
نذیر میرٹھی 	/poets/nazeer-meeruthy?lang=ur
نذیر مرزا برلاس 	/poets/nazeer-mirza-barlas?lang=ur
نظیر محسن 	/poets/nazeer-mohsin?lang=ur
نظیر مظفرپوری 	/poets/nazeer-muzaffarpuri?lang=ur
نذیر نظر 	/poets/nazeer-nazar?lang=ur
نذیر قیصر 	/poets/nazeer-qaisar?lang=ur
نظیر رامپوری 	/poets/nazeer-rampuri?lang=ur
نظیر صدیقی 	/poets/nazeer-siddiqui?lang=ur
نذیر تبسم 	/poets/nazeer-tabassum?lang=ur
ناظم بریلوی 	/poets/nazim-barelvi?lang=ur
ناظم نقوی 	/poets/nazim-naqvi?lang=ur
ناظم سلطانپوری 	/poets/nazim-sultanpuri?lang=ur
ناظر الحسینی 	/poets/nazir-al-husaini?lang=ur
نذیر فتح پوری 	/poets/nazir-fatehpuri?lang=ur
ناظر صدیقی 	/poets/nazir-siddiqi?lang=ur
ناظر وحید 	/poets/nazir-wahid?lang=ur
نازش کاشمیری 	/poets/nazish-kashmiri?lang=ur
نازش پرتاپ گڑھی 	/poets/nazish-partap-gadhi?lang=ur
نازش رضوی 	/poets/nazish-rizvi?lang=ur
نازش سکندرپوری 	/poets/nazish-sikandarpuri?lang=ur
نظم طبا طبائی 	/poets/nazm-tabaa-tabaaii?lang=ur
نظمی سکندری آبادی 	/poets/nazmi-sikandrabadi?lang=ur
نازنین بیگم ناز 	/poets/nazneen-begum-naz?lang=ur
نیل احمد 	/poets/neel-ahmed?lang=ur
نیلما سرور 	/poets/neelma-sarwar?lang=ur
نینا سحر 	/poets/neena-sahar?lang=ur
نیرج گوسوامی 	/poets/neeraj-goswami?lang=ur
ندا فاضلی 	/poets/nida-fazli?lang=ur
نگار عظیم 	/poets/nigar-azeem?lang=ur
نہال لکھنوی 	/poets/nihal-lakhnavi?lang=ur
نہال رضوی 	/poets/nihal-rizvi?lang=ur
نہال سیوہاروی 	/poets/nihal-sevharvi?lang=ur
نکہت بریلوی 	/poets/nikhat-barelvi?lang=ur
نکہت افتخار 	/poets/nikhat-iftikhar?lang=ur
نکہت یاسمین گل 	/poets/nikhat-yasmeen-gul?lang=ur
نیلوفر افضل 	/poets/nilofar-afzal?lang=ur
نثار اٹاوی 	/poets/nisar-itavi?lang=ur
نثار کبریٰ 	/poets/nisar-kubra?lang=ur
نثار محمود تاثیر 	/poets/nisar-mahmood-taseer?lang=ur
نثار ناسک 	/poets/nisar-nasik?lang=ur
نثار ترین جاذب 	/poets/nisar-tareen-jazib?lang=ur
نثار ترابی 	/poets/nisar-turabi?lang=ur
نشانت شری واستو نایاب 	/poets/nishant-shrivastava-nayab?lang=ur
نتن نایاب 	/poets/nitin-nayab?lang=ur
نویش ساہو 	/poets/nivesh-sahu?lang=ur
نیاز بریلوی 	/poets/niyaz-barelvi?lang=ur
نیاز فتح پوری 	/poets/niyaz-fatehpuri?lang=ur
نیاز حیدر 	/poets/niyaz-haidar?lang=ur
نیاز حسین لکھویرا 	/poets/niyaz-husain-lakhwera?lang=ur
نیاز جیراجپوری 	/poets/niyaz-jairajpuri?lang=ur
نظام رامپوری 	/poets/nizam-rampuri?lang=ur
نظام الدین نظام 	/poets/nizamuddin-nizam?lang=ur
نعمان شوق 	/poets/nomaan-shauque?lang=ur
نعمان فاروق 	/poets/noman-farooq?lang=ur
نعمان امام 	/poets/noman-imam?lang=ur
نوح ناروی 	/poets/nooh-narvi?lang=ur
ن م دانش 	/poets/noon-meem-danish?lang=ur
ن م راشد 	/poets/noon-meem-rashid?lang=ur
نور بجنوری 	/poets/noor-bijnauri?lang=ur
نور فاطمہ نور 	/poets/noor-fatima-noor?lang=ur
نور اندوری 	/poets/noor-indori?lang=ur
نور جہاں ناز 	/poets/noor-jahan-naz?lang=ur
نور جہاں ثروت 	/poets/noor-jahan-sarwat?lang=ur
نور محمد نور 	/poets/noor-mohammad-noor?lang=ur
نور محمد یاس 	/poets/noor-mohammad-yaas?lang=ur
نور منیری 	/poets/noor-muneeri?lang=ur
نور این ساحر 	/poets/noor-n-sahir?lang=ur
نور پرکار 	/poets/noor-parkar?lang=ur
نور تقی نور 	/poets/noor-taqi-noor?lang=ur
نورین طلعت عروبہ 	/poets/noorain-talat-arooba?lang=ur
نور العین قیصر قاسمی 	/poets/noorul-ain-qaisar-qasmi?lang=ur
نوشی گیلانی 	/poets/noshi-gilani?lang=ur
ندرت نواز 	/poets/nudrat-nawaz?lang=ur
نجومی بلیاوی 	/poets/nujumi-balyavi?lang=ur
نشور واحدی 	/poets/nushur-wahidi?lang=ur
نصرت گوالیاری 	/poets/nusrat-gwaliari?lang=ur
نصرت لکھنوی 	/poets/nusrat-lakhnavi?lang=ur
نصرت مسعود 	/poets/nusrat-masood?lang=ur
نصرت مہدی 	/poets/nusrat-mehdi?lang=ur
نصرت صدیقی 	/poets/nusrat-siddiqui?lang=ur
نزہت نگار 	/poets/nuzhat-nigar?lang=ur
عبید حارث 	/poets/obaid-haris?lang=ur
عبید صدیقی 	/poets/obaid-siddiqi?lang=ur
عبید اللہ علیم 	/poets/obaidullah-aleem?lang=ur
عبید اللہ خاں مبتلا 	/poets/obaidullah-khan-mubtala?lang=ur
عبید اللہ صدیقی 	/poets/obaidullah-siddiqui?lang=ur
عبید الرحمان 	/poets/obaidur-rahman?lang=ur
عبید الرحمان اعظمی 	/poets/obaidur-rahman-azmi?lang=ur
اوم کرشن راحت 	/poets/om-krishn-rahat?lang=ur
اوم پرکاش بجاج 	/poets/om-parkash-bajaj?lang=ur
اوم پرکاش لاغر 	/poets/om-prakash-laghar?lang=ur
اسامہ امیر 	/poets/osaama-ameer?lang=ur
اسامہ خالد 	/poets/osama-khalid?lang=ur
اسامہ ذاکر 	/poets/osama-zakir?lang=ur
اویس احمد دوراں 	/poets/owais-ahmad-dauran?lang=ur
اویس الحسن خان 	/poets/owaisul-hassan-khan?lang=ur
عزیر رحمان 	/poets/ozair-rahman?lang=ur
عبید حارث 	/poets/obaid-haris?lang=ur
عبید صدیقی 	/poets/obaid-siddiqi?lang=ur
عبید اللہ علیم 	/poets/obaidullah-aleem?lang=ur
عبید اللہ خاں مبتلا 	/poets/obaidullah-khan-mubtala?lang=ur
عبید اللہ صدیقی 	/poets/obaidullah-siddiqui?lang=ur
عبید الرحمان 	/poets/obaidur-rahman?lang=ur
عبید الرحمان اعظمی 	/poets/obaidur-rahman-azmi?lang=ur
اوم کرشن راحت 	/poets/om-krishn-rahat?lang=ur
اوم پرکاش بجاج 	/poets/om-parkash-bajaj?lang=ur
اوم پرکاش لاغر 	/poets/om-prakash-laghar?lang=ur
اسامہ امیر 	/poets/osaama-ameer?lang=ur
اسامہ خالد 	/poets/osama-khalid?lang=ur
اسامہ ذاکر 	/poets/osama-zakir?lang=ur
اویس احمد دوراں 	/poets/owais-ahmad-dauran?lang=ur
اویس الحسن خان 	/poets/owaisul-hassan-khan?lang=ur
عزیر رحمان 	/poets/ozair-rahman?lang=ur
پی.پی سری واستو رند 	/poets/p-p-srivastava-rind?lang=ur
پیغام آفاقی 	/poets/paigham-aafaqi?lang=ur
پلو مشرا 	/poets/pallav-mishra?lang=ur
پنڈت چندر بھان برہمن 	/poets/pandit-chandr-bhan-barahman?lang=ur
پنڈت دیا شنکر نسیم لکھنوی 	/poets/pandit-daya-shankar-naseem-lakhnavi?lang=ur
پنڈت جگموہن ناتھ رینا شوق 	/poets/pandit-jagmohan-nath-raina-shauq?lang=ur
پنڈت جواہر ناتھ ساقی 	/poets/pandit-jawahar-nath-saqi?lang=ur
پنکج سرحدی 	/poets/pankaj-sarhadi?lang=ur
پنکج سبیر 	/authors/pankaj-subeer?lang=ur
پرکاش فکری 	/poets/parkash-fikri?lang=ur
پرکاش ناتھ پرویز 	/poets/parkash-nath-parvez?lang=ur
پرکاش تیواری 	/poets/parkash-tiwari?lang=ur
پرتو روہیلہ 	/poets/partav-rohila?lang=ur
پروین فنا سید 	/poets/parveen-fana-syed?lang=ur
پروین کمار اشک 	/poets/parveen-kumar-ashk?lang=ur
پروین مرزا 	/poets/parveen-mirza?lang=ur
پروین شاکر 	/poets/parveen-shakir?lang=ur
پروین طاہر 	/poets/parveen-tahir?lang=ur
پروین ام مشتاق 	/poets/parveen-umm-e-mushtaq?lang=ur
پرویز اختر 	/poets/parvez-akhtar?lang=ur
پرویز بزمی 	/poets/parvez-bazmi?lang=ur
پرویز ساحر 	/poets/parvez-sahir?lang=ur
پرویز شاہدی 	/poets/parvez-shahidi?lang=ur
پروین شیر 	/poets/parvin-sheer?lang=ur
پروندر شوخ 	/poets/parvindar-shokh?lang=ur
پرواز جالندھری 	/poets/parwaz-jalandhari?lang=ur
پون کمار 	/poets/pawan-kumar?lang=ur
پیام فتحپوری 	/poets/payam-fatehpuri?lang=ur
پیر اکرم 	/poets/peer-akram?lang=ur
پیر نصیر الدین شاہ نصیر 	/poets/peer-nasiruddin-shah-naseer?lang=ur
پیر شیر محمد عاجز 	/poets/peer-sher-mohammad-ajiz?lang=ur
پرویز شہریار 	/poets/perwaiz-shaharyar?lang=ur
پنہاں سپہر آرا خاتون 	/poets/pinhaan-sipher-ara-khatoon?lang=ur
پیرزادہ قاسم 	/poets/pirzada-qasim?lang=ur
پیارے لال رونق دہلوی 	/poets/piyare-lal-raunaq-dehlwi?lang=ur
پونم یادو 	/poets/poonam-yadav?lang=ur
پربدھ سوربھ 	/poets/prabudha-saurabh?lang=ur
پرکھر مالوی کانھا 	/poets/prakhar-malviya-kanha?lang=ur
پرمود شرما اثر 	/poets/pramod-sharma-asar?lang=ur
پرتاپ سوم ونشی 	/poets/pratap-somvanshi?lang=ur
پریم بھنڈاری 	/poets/prem-bhandari?lang=ur
پریم کمار نظر 	/poets/prem-kumar-nazar?lang=ur
پریم شنکر گوئلہ فرحت 	/poets/prem-shankar-goila-farhat?lang=ur
پریم واربرٹنی 	/poets/prem-warbartani-3?lang=ur
پریمی رومانی 	/poets/premi-rumani?lang=ur
پریس ہاتھی راقم 	/poets/preyas-hathi-raqim?lang=ur
پرتپال سنگھ بیتاب 	/poets/pritpal-singh-betab?lang=ur
پریا تابیتا 	/poets/priya-tabita?lang=ur
پریہ درشی ٹھا کرخیال 	/poets/priyadarshi-thakur-khayal?lang=ur
پوجا بھاٹیا 	/poets/puja-bhatia?lang=ur
پی.پی سری واستو رند 	/poets/p-p-srivastava-rind?lang=ur
پیغام آفاقی 	/poets/paigham-aafaqi?lang=ur
پلو مشرا 	/poets/pallav-mishra?lang=ur
پنڈت چندر بھان برہمن 	/poets/pandit-chandr-bhan-barahman?lang=ur
پنڈت دیا شنکر نسیم لکھنوی 	/poets/pandit-daya-shankar-naseem-lakhnavi?lang=ur
پنڈت جگموہن ناتھ رینا شوق 	/poets/pandit-jagmohan-nath-raina-shauq?lang=ur
پنڈت جواہر ناتھ ساقی 	/poets/pandit-jawahar-nath-saqi?lang=ur
پنکج سرحدی 	/poets/pankaj-sarhadi?lang=ur
پنکج سبیر 	/authors/pankaj-subeer?lang=ur
پرکاش فکری 	/poets/parkash-fikri?lang=ur
پرکاش ناتھ پرویز 	/poets/parkash-nath-parvez?lang=ur
پرکاش تیواری 	/poets/parkash-tiwari?lang=ur
پرتو روہیلہ 	/poets/partav-rohila?lang=ur
پروین فنا سید 	/poets/parveen-fana-syed?lang=ur
پروین کمار اشک 	/poets/parveen-kumar-ashk?lang=ur
پروین مرزا 	/poets/parveen-mirza?lang=ur
پروین شاکر 	/poets/parveen-shakir?lang=ur
پروین طاہر 	/poets/parveen-tahir?lang=ur
پروین ام مشتاق 	/poets/parveen-umm-e-mushtaq?lang=ur
پرویز اختر 	/poets/parvez-akhtar?lang=ur
پرویز بزمی 	/poets/parvez-bazmi?lang=ur
پرویز ساحر 	/poets/parvez-sahir?lang=ur
پرویز شاہدی 	/poets/parvez-shahidi?lang=ur
پروین شیر 	/poets/parvin-sheer?lang=ur
پروندر شوخ 	/poets/parvindar-shokh?lang=ur
پرواز جالندھری 	/poets/parwaz-jalandhari?lang=ur
پون کمار 	/poets/pawan-kumar?lang=ur
پیام فتحپوری 	/poets/payam-fatehpuri?lang=ur
پیر اکرم 	/poets/peer-akram?lang=ur
پیر نصیر الدین شاہ نصیر 	/poets/peer-nasiruddin-shah-naseer?lang=ur
پیر شیر محمد عاجز 	/poets/peer-sher-mohammad-ajiz?lang=ur
پرویز شہریار 	/poets/perwaiz-shaharyar?lang=ur
پنہاں سپہر آرا خاتون 	/poets/pinhaan-sipher-ara-khatoon?lang=ur
پیرزادہ قاسم 	/poets/pirzada-qasim?lang=ur
پیارے لال رونق دہلوی 	/poets/piyare-lal-raunaq-dehlwi?lang=ur
پونم یادو 	/poets/poonam-yadav?lang=ur
پربدھ سوربھ 	/poets/prabudha-saurabh?lang=ur
پرکھر مالوی کانھا 	/poets/prakhar-malviya-kanha?lang=ur
پرمود شرما اثر 	/poets/pramod-sharma-asar?lang=ur
پرتاپ سوم ونشی 	/poets/pratap-somvanshi?lang=ur
پریم بھنڈاری 	/poets/prem-bhandari?lang=ur
پریم کمار نظر 	/poets/prem-kumar-nazar?lang=ur
پریم شنکر گوئلہ فرحت 	/poets/prem-shankar-goila-farhat?lang=ur
پریم واربرٹنی 	/poets/prem-warbartani-3?lang=ur
پریمی رومانی 	/poets/premi-rumani?lang=ur
پریس ہاتھی راقم 	/poets/preyas-hathi-raqim?lang=ur
پرتپال سنگھ بیتاب 	/poets/pritpal-singh-betab?lang=ur
پریا تابیتا 	/poets/priya-tabita?lang=ur
پریہ درشی ٹھا کرخیال 	/poets/priyadarshi-thakur-khayal?lang=ur
پوجا بھاٹیا 	/poets/puja-bhatia?lang=ur
پنڈت امرناتھ ہوشیارپوری 	/poets/pundit-amar-nath-hoshiyarpuri?lang=ur
پرنم الہ آبادی 	/poets/purnam-allahabadi?lang=ur
پرشوتم ابّی آذر 	/poets/purshottam-abbi-azer?lang=ur
قابل اجمیری 	/poets/qabil-ajmeri?lang=ur
قدر بلگرامی 	/poets/qadr-bilgarami?lang=ur
قیس جالندھری 	/poets/qais-jalandhari?lang=ur
قیس کاکوروی 	/poets/qais-kakorvi?lang=ur
قیس رامپوری 	/poets/qais-rampuri?lang=ur
قیصر عباس 	/poets/qaisar-abbas?lang=ur
قیصر حیات 	/poets/qaisar-hayat?lang=ur
قیصر نظامی 	/poets/qaisar-nizami?lang=ur
قیصر قلندر 	/poets/qaisar-qalandar?lang=ur
قیصر شمیم 	/poets/qaisar-shameem?lang=ur
قیصر صدیقی 	/poets/qaisar-siddiqi?lang=ur
قیصر امراوتوی 	/poets/qaisar-umrao-tovi?lang=ur
قیصر عثمانی 	/poets/qaisar-usmani?lang=ur
قیصر الجعفری 	/poets/qaisar-ul-jafri?lang=ur
قلیل جھانسوی 	/poets/qaleel-jhansvi?lang=ur
قمر عباس قمر 	/poets/qamar-abbas-qamar?lang=ur
قمر بدرپوری 	/poets/qamar-badarpuri?lang=ur
قمر ہاشمی 	/poets/qamar-hashmi?lang=ur
قمر اقبال 	/poets/qamar-iqbal?lang=ur
قمر جلال آبادی 	/poets/qamar-jalalabadi?lang=ur
قمر جلالوی 	/poets/qamar-jalalvi?lang=ur
قمر جمیل 	/poets/qamar-jameel?lang=ur
قمر مرادآبادی 	/poets/qamar-moradabadi?lang=ur
قمر نقوی 	/poets/qamar-naqvi?lang=ur
قمر رئیس 	/poets/qamar-raees?lang=ur
قمر رضا شہزاد 	/poets/qamar-raza-shahzad?lang=ur
قمر سنبھلی 	/poets/qamar-sanbhali?lang=ur
قمر صدیقی 	/poets/qamar-siddiqi?lang=ur
قمر النساء قمر 	/poets/qamar-un-nisa-qamar?lang=ur
قمرالدین خورشید 	/poets/qamruddeen-khurshid?lang=ur
قمرالدین 	/poets/qamruddin?lang=ur
قاصد عزیز 	/poets/qasid-aziz?lang=ur
قاسم علی خان آفریدی 	/poets/qasim-ali-khan-afridi?lang=ur
قاسم جلال 	/poets/qasim-jalal?lang=ur
قاسم نیازی 	/poets/qasim-niyazi?lang=ur
قاسم یعقوب 	/poets/qasim-yaqub?lang=ur
قتیل شفائی 	/poets/qateel-shifai?lang=ur
قوس صدیقی 	/poets/qaus-siddiqui?lang=ur
قائم چاندپوری 	/poets/qayem-chandpuri?lang=ur
قائم نقوی 	/poets/qayem-naqvi?lang=ur
قیوم شاکر 	/poets/qayoom-shakri?lang=ur
قیوم نظر 	/poets/qayyum-nazar?lang=ur
قیوم طاہر 	/poets/qayyum-tahir?lang=ur
قزلباش خاں امید 	/poets/qazalbash-khan-ummeed?lang=ur
قاضی انصار 	/poets/qazi-ansar?lang=ur
قاضی احتشام بچھرونی 	/poets/qazi-ehtisham-bachhrauni?lang=ur
قاضی اعجاز محور 	/poets/qazi-ejaz-mehwar?lang=ur
قاضی حبیب الرحمن 	/poets/qazi-habiburrahman?lang=ur
قاضی حسن رضا 	/poets/qazi-hasan-raza?lang=ur
قاضی محمود بحری 	/poets/qazi-mahmud-behri?lang=ur
قابل اجمیری 	/poets/qabil-ajmeri?lang=ur
قدر بلگرامی 	/poets/qadr-bilgarami?lang=ur
قیس جالندھری 	/poets/qais-jalandhari?lang=ur
قیس کاکوروی 	/poets/qais-kakorvi?lang=ur
قیس رامپوری 	/poets/qais-rampuri?lang=ur
قیصر عباس 	/poets/qaisar-abbas?lang=ur
قیصر حیات 	/poets/qaisar-hayat?lang=ur
قیصر نظامی 	/poets/qaisar-nizami?lang=ur
قیصر قلندر 	/poets/qaisar-qalandar?lang=ur
قیصر شمیم 	/poets/qaisar-shameem?lang=ur
قیصر صدیقی 	/poets/qaisar-siddiqi?lang=ur
قیصر امراوتوی 	/poets/qaisar-umrao-tovi?lang=ur
قیصر عثمانی 	/poets/qaisar-usmani?lang=ur
قیصر الجعفری 	/poets/qaisar-ul-jafri?lang=ur
قلیل جھانسوی 	/poets/qaleel-jhansvi?lang=ur
قمر عباس قمر 	/poets/qamar-abbas-qamar?lang=ur
قمر بدرپوری 	/poets/qamar-badarpuri?lang=ur
قمر ہاشمی 	/poets/qamar-hashmi?lang=ur
قمر اقبال 	/poets/qamar-iqbal?lang=ur
قمر جلال آبادی 	/poets/qamar-jalalabadi?lang=ur
قمر جلالوی 	/poets/qamar-jalalvi?lang=ur
قمر جمیل 	/poets/qamar-jameel?lang=ur
قمر مرادآبادی 	/poets/qamar-moradabadi?lang=ur
قمر نقوی 	/poets/qamar-naqvi?lang=ur
قمر رئیس 	/poets/qamar-raees?lang=ur
قمر رضا شہزاد 	/poets/qamar-raza-shahzad?lang=ur
قمر سنبھلی 	/poets/qamar-sanbhali?lang=ur
قمر صدیقی 	/poets/qamar-siddiqi?lang=ur
قمر النساء قمر 	/poets/qamar-un-nisa-qamar?lang=ur
قمرالدین خورشید 	/poets/qamruddeen-khurshid?lang=ur
قمرالدین 	/poets/qamruddin?lang=ur
قاصد عزیز 	/poets/qasid-aziz?lang=ur
قاسم علی خان آفریدی 	/poets/qasim-ali-khan-afridi?lang=ur
قاسم جلال 	/poets/qasim-jalal?lang=ur
قاسم نیازی 	/poets/qasim-niyazi?lang=ur
قاسم یعقوب 	/poets/qasim-yaqub?lang=ur
قتیل شفائی 	/poets/qateel-shifai?lang=ur
قوس صدیقی 	/poets/qaus-siddiqui?lang=ur
قائم چاندپوری 	/poets/qayem-chandpuri?lang=ur
قائم نقوی 	/poets/qayem-naqvi?lang=ur
قیوم شاکر 	/poets/qayoom-shakri?lang=ur
قیوم نظر 	/poets/qayyum-nazar?lang=ur
قیوم طاہر 	/poets/qayyum-tahir?lang=ur
قزلباش خاں امید 	/poets/qazalbash-khan-ummeed?lang=ur
قاضی انصار 	/poets/qazi-ansar?lang=ur
قاضی احتشام بچھرونی 	/poets/qazi-ehtisham-bachhrauni?lang=ur
قاضی اعجاز محور 	/poets/qazi-ejaz-mehwar?lang=ur
قاضی حبیب الرحمن 	/poets/qazi-habiburrahman?lang=ur
قاضی حسن رضا 	/poets/qazi-hasan-raza?lang=ur
قاضی محمود بحری 	/poets/qazi-mahmud-behri?lang=ur
قاضی سلیم 	/poets/qazi-saleem?lang=ur
قیصر خالد 	/poets/quaiser-khalid?lang=ur
قلی قطب شاہ 	/poets/quli-qutub-shah?lang=ur
قربان آتش 	/poets/qurban-aatish?lang=ur
قربان علی سالک بیگ 	/poets/qurban-ali-salik-beg?lang=ur
قربی ویلوری 	/poets/qurbi-velori?lang=ur
رابعہ پنہاں 	/poets/raabia-pinhan?lang=ur
رازؔ الٰہ آبادی 	/poets/raaz-allahabadi?lang=ur
راز لائلپوری 	/poets/raaz-layalpuri?lang=ur
راز مراد آبادی 	/poets/raaz-muradabadi?lang=ur
راز یزدانی 	/poets/raaz-yazdani?lang=ur
رب نواز مائل 	/poets/rab-nawaz-mael?lang=ur
رباب رشیدی 	/poets/rabab-rashidi?lang=ur
ربیعہ فخری 	/poets/rabia-fakhri?lang=ur
رادھے شیام رستوگی احقر 	/poets/radhe-shiyam-rastogi-ahqar?lang=ur
رئیس اختر 	/poets/raees-akhtar?lang=ur
رئیس انصاری 	/poets/raees-ansari?lang=ur
رئیس باغی 	/poets/raees-baghi?lang=ur
رئیس فراز 	/poets/raees-faraz?lang=ur
رئیس مینائی 	/poets/raees-minai?lang=ur
رئیس ناروی 	/poets/raees-narvi?lang=ur
رئیس نیازی 	/poets/raees-niyazi?lang=ur
رئیس رامپوری 	/poets/raees-rampuri?lang=ur
رئیس وارثی 	/poets/raees-warsi?lang=ur
رئیس الدین فریدی 	/poets/raeesuddin-fareedi?lang=ur
رئیس الدین رئیس 	/poets/raeesuddin-raees?lang=ur
رئیس الدین طہور جعفری 	/poets/raeesuddin-tahoor-jafri?lang=ur
رفعت شمیم 	/poets/rafat-shameem?lang=ur
رفیع رضا 	/poets/rafi-raza?lang=ur
رفیعہ شبنم عابدی 	/poets/rafia-shabnam-abidi?lang=ur
رفیق خاور جسکانی 	/poets/rafiq-khawar-jaskani?lang=ur
رفیق راز 	/poets/rafiq-raaz?lang=ur
رفیق سندیلوی 	/poets/rafiq-sandelvi?lang=ur
رفیق خیال 	/poets/rafique-khayal?lang=ur
رفیق الزماں 	/poets/rafiquzzaman?lang=ur
رفیع اللہ میاں 	/poets/rafiullah-mian?lang=ur
راغب اختر 	/poets/raghib-akhtar?lang=ur
راغب بدایونی 	/poets/raghib-badayuni?lang=ur
راغب مرادآبادی 	/poets/raghib-muradabadi?lang=ur
رگھونندن شرما 	/poets/raghunandan-sharma?lang=ur
رگھوناتھ سہائے 	/poets/raghunath-sahai?lang=ur
راغب شکیب 	/poets/ragib-shakeb?lang=ur
راحت حسن 	/poets/rahat-hasan?lang=ur
راحتؔ اندوری 	/poets/rahat-indori?lang=ur
راحت نسیم ملک 	/poets/rahat-naseem-malik?lang=ur
راحت سرحدی 	/poets/rahat-sarhadi?lang=ur
رہبر جونپوری 	/poets/rahber-jaunpuri?lang=ur
راحیل فاروق 	/poets/raheel-farooq?lang=ur
راہی فدائی 	/poets/rahi-fidai?lang=ur
راہی معصوم رضا 	/poets/rahi-masoom-raza?lang=ur
راہی قریشی 	/poets/rahi-quraishi?lang=ur
راہی شہابی 	/poets/rahi-shahabi?lang=ur
راحل بخاری 	/poets/rahil-bukhari?lang=ur
رحمان حفیظ 	/poets/rahman-hafeez?lang=ur
رحمان جامی 	/poets/rahman-jami?lang=ur
رحمان خاور 	/poets/rahman-khawar?lang=ur
رابعہ پنہاں 	/poets/raabia-pinhan?lang=ur
رازؔ الٰہ آبادی 	/poets/raaz-allahabadi?lang=ur
راز لائلپوری 	/poets/raaz-layalpuri?lang=ur
راز مراد آبادی 	/poets/raaz-muradabadi?lang=ur
راز یزدانی 	/poets/raaz-yazdani?lang=ur
رب نواز مائل 	/poets/rab-nawaz-mael?lang=ur
رباب رشیدی 	/poets/rabab-rashidi?lang=ur
ربیعہ فخری 	/poets/rabia-fakhri?lang=ur
رادھے شیام رستوگی احقر 	/poets/radhe-shiyam-rastogi-ahqar?lang=ur
رئیس اختر 	/poets/raees-akhtar?lang=ur
رئیس انصاری 	/poets/raees-ansari?lang=ur
رئیس باغی 	/poets/raees-baghi?lang=ur
رئیس فراز 	/poets/raees-faraz?lang=ur
رئیس مینائی 	/poets/raees-minai?lang=ur
رئیس ناروی 	/poets/raees-narvi?lang=ur
رئیس نیازی 	/poets/raees-niyazi?lang=ur
رئیس رامپوری 	/poets/raees-rampuri?lang=ur
رئیس وارثی 	/poets/raees-warsi?lang=ur
رئیس الدین فریدی 	/poets/raeesuddin-fareedi?lang=ur
رئیس الدین رئیس 	/poets/raeesuddin-raees?lang=ur
رئیس الدین طہور جعفری 	/poets/raeesuddin-tahoor-jafri?lang=ur
رفعت شمیم 	/poets/rafat-shameem?lang=ur
رفیع رضا 	/poets/rafi-raza?lang=ur
رفیعہ شبنم عابدی 	/poets/rafia-shabnam-abidi?lang=ur
رفیق خاور جسکانی 	/poets/rafiq-khawar-jaskani?lang=ur
رفیق راز 	/poets/rafiq-raaz?lang=ur
رفیق سندیلوی 	/poets/rafiq-sandelvi?lang=ur
رفیق خیال 	/poets/rafique-khayal?lang=ur
رفیق الزماں 	/poets/rafiquzzaman?lang=ur
رفیع اللہ میاں 	/poets/rafiullah-mian?lang=ur
راغب اختر 	/poets/raghib-akhtar?lang=ur
راغب بدایونی 	/poets/raghib-badayuni?lang=ur
راغب مرادآبادی 	/poets/raghib-muradabadi?lang=ur
رگھونندن شرما 	/poets/raghunandan-sharma?lang=ur
رگھوناتھ سہائے 	/poets/raghunath-sahai?lang=ur
راغب شکیب 	/poets/ragib-shakeb?lang=ur
راحت حسن 	/poets/rahat-hasan?lang=ur
راحتؔ اندوری 	/poets/rahat-indori?lang=ur
راحت نسیم ملک 	/poets/rahat-naseem-malik?lang=ur
راحت سرحدی 	/poets/rahat-sarhadi?lang=ur
رہبر جونپوری 	/poets/rahber-jaunpuri?lang=ur
راحیل فاروق 	/poets/raheel-farooq?lang=ur
راہی فدائی 	/poets/rahi-fidai?lang=ur
راہی معصوم رضا 	/poets/rahi-masoom-raza?lang=ur
راہی قریشی 	/poets/rahi-quraishi?lang=ur
راہی شہابی 	/poets/rahi-shahabi?lang=ur
راحل بخاری 	/poets/rahil-bukhari?lang=ur
رحمان حفیظ 	/poets/rahman-hafeez?lang=ur
رحمان جامی 	/poets/rahman-jami?lang=ur
رحمان خاور 	/poets/rahman-khawar?lang=ur
رحمت امروہوی 	/poets/rahmat-amrohvi?lang=ur
رحمت الٰہی برق اعظمی 	/poets/rahmat-ilahi-barq-aazmi?lang=ur
رحمت قرنی 	/poets/rahmat-qarni?lang=ur
راہل جھا 	/poets/rahul-jha?lang=ur
رئیس امروہوی 	/poets/rais-amrohvi?lang=ur
رئیس فروغ 	/poets/rais-farogh?lang=ur
رئیس صدیقی 	/poets/rais-siddiqui?lang=ur
راج بہادر سکسینہ اوجؔ 	/poets/raj-bahadur-saxena-auj?lang=ur
راج کوشک 	/poets/raj-kaushik?lang=ur
راج کھیتی 	/poets/raj-kheti?lang=ur
راج کمار قیس 	/poets/raj-kumar-qais?lang=ur
راج کمار سوری ندیم 	/poets/raj-kumar-soori-nadeem?lang=ur
راج نرائن راز 	/poets/raj-narayan-raaz?lang=ur
رجب علی بیگ سرور 	/poets/rajab-ali-beg-suroor?lang=ur
راجندر کلکل 	/poets/rajendra-kalkal?lang=ur
راجندر ناتھ رہبر 	/poets/rajendra-nath-rahbar?lang=ur
راجیش ریڈی 	/poets/rajesh-reddy?lang=ur
راجیندر کرشن 	/poets/rajinder-krishan?lang=ur
راجیندر منچندا بانی 	/poets/rajinder-manchanda-bani?lang=ur
رجنیش سچن 	/poets/rajneesh-sachan?lang=ur
راکیش راہی 	/poets/rakesh-rahi?lang=ur
رخشاں ہاشمی 	/poets/rakhshan-hashmi?lang=ur
رخشندہ نوید 	/poets/rakhshanda-naved?lang=ur
راکب مختار 	/poets/rakib-mukhtar?lang=ur
رام اوتار گپتا مضظر 	/poets/ram-awtar-gupta-muztar?lang=ur
رام داس 	/poets/ram-daas?lang=ur
رام کرشن مضطر 	/poets/ram-krishn-muztar?lang=ur
رام ناتھ اسیر 	/poets/ram-nath-aseer?lang=ur
رام پرکاش راہی 	/poets/ram-parkash-rahi?lang=ur
رام ریاض 	/poets/ram-riyaz?lang=ur
رمیش کنول 	/poets/ramesh-kanwal?lang=ur
رمز آفاقی 	/poets/ramz-afaqi?lang=ur
رمز عظیم آبادی 	/poets/ramz-azimabadi?lang=ur
رمضان علی سحر 	/poets/ramzan-ali-sahar?lang=ur
رمزی آثم 	/poets/ramzi-asim?lang=ur
رانا اکبرآبادی 	/poets/rana-akbarabadi?lang=ur
رانا عامر لیاقت 	/poets/rana-amir-liyaqat?lang=ur
رانا گنوری 	/poets/rana-gannauri?lang=ur
رانا سعید دوشی 	/poets/rana-saeed-doshi?lang=ur
رعنا سحری 	/poets/rana-sahri?lang=ur
رنگیں سعادت یار خاں 	/poets/rangin-saadat-yaar-khan?lang=ur
رنجور عظیم آبادی 	/poets/ranjoor-azimabadi?lang=ur
رؤف امیر 	/poets/raoof-ameer?lang=ur
راقم دہلوی 	/poets/raqim-dehlavi?lang=ur
رسا چغتائی 	/poets/rasa-chughtai?lang=ur
رسا رامپوری 	/poets/rasa-rampuri?lang=ur
رشید افروز 	/poets/rasheed-afroz?lang=ur
رشید عیاں 	/poets/rasheed-ayan?lang=ur
رشید اعجاز 	/poets/rasheed-ejaz?lang=ur
رشید جاوید 	/poets/rasheed-javed?lang=ur
رشید کامل 	/poets/rasheed-kamil?lang=ur
رشید کوثر فاروقی 	/poets/rasheed-kausar-farooqi?lang=ur
رشید لکھنوی 	/poets/rasheed-lakhnavi?lang=ur
رشید نثار 	/poets/rasheed-nisar?lang=ur
رشید قیصرانی 	/poets/rasheed-qaisrani?lang=ur
رشید رامپوری 	/poets/rasheed-rampuri?lang=ur
رشید عثمانی 	/poets/rasheed-usmani?lang=ur
راشدہ ماہین ملک 	/poets/rasheeda-maheen-malik?lang=ur
رشیدہ سلیم سیمیں 	/poets/rasheeda-saleem-seemin?lang=ur
رشیدالظفر 	/poets/rasheeduzzafar?lang=ur
راشد آذر 	/poets/rashid-aazar?lang=ur
راشد امین 	/poets/rashid-ameen?lang=ur
راشد انور راشد 	/poets/rashid-anwar-rashid?lang=ur
راشد بنارسی 	/poets/rashid-banarasi?lang=ur
راشد فضلی 	/poets/rashid-fazli?lang=ur
راشد حامدی 	/poets/rashid-hamidi?lang=ur
راشد حسن رانا 	/poets/rashid-hasan-rana?lang=ur
رشید امکان 	/poets/rashid-imkan?lang=ur
راشد جمال فاروقی 	/poets/rashid-jamaal-farooqi?lang=ur
راشد کامل 	/poets/rashid-kamil?lang=ur
راشد متین 	/poets/rashid-mateen?lang=ur
راشد مفتی 	/poets/rashid-mufti?lang=ur
راشد مراد 	/poets/rashid-mura?lang=ur
راشد نور 	/poets/rashid-noor?lang=ur
راشد قیوم انصر 	/poets/rashid-qayyum-ansar?lang=ur
راشد راہی 	/poets/rashid-rahi?lang=ur
رشید شاہجہانپوری 	/poets/rashid-shahjahanpuri?lang=ur
راشد طراز 	/poets/rashid-taraz?lang=ur
رشک خلیلی 	/poets/rashk-khaleeli?lang=ur
رشمی بھاردواج 	/poets/rashmi-bhardwaj?lang=ur
رشمی صبا 	/poets/rashmi-saba?lang=ur
راسخ عظیم آبادی 	/poets/rasikh-azimabadi?lang=ur
راسخ فارانی 	/poets/rasikh-farani?lang=ur
راسخ عرفانی 	/poets/rasikh-irfani?lang=ur
رسول جہاں بیگم مخفی بدایونی 	/poets/rasool-jahan-begam-makhfi-badayuni?lang=ur
رسول ساقی 	/poets/rasool-saqi?lang=ur
رتن ناتھ سرشار 	/poets/ratan-nath-sarshar?lang=ur
رتن پنڈوروی 	/poets/ratan-pandorwi?lang=ur
رؤف خیر 	/poets/rauf-khair?lang=ur
رؤف خلش 	/poets/rauf-khalish?lang=ur
رؤف رضا 	/poets/rauf-raza?lang=ur
رؤف صادق 	/poets/rauf-sadiq?lang=ur
رؤف یاسین جلالی 	/poets/rauf-yasin-jalali?lang=ur
رونق دکنی 	/poets/raunaq-deccani?lang=ur
رونق نعیم 	/poets/raunaq-naeem?lang=ur
 رونق رضا 	/poets/raunaq-raza?lang=ur
رونق ٹونکوی 	/poets/raunaq-tonkvi?lang=ur
روشن لال روشن 	/poets/raushan-laal-raushan?lang=ur
روشن نگینوی 	/poets/raushan-naginvi?lang=ur
روی کمار 	/poets/ravi-kumar?lang=ur
روش ندیم 	/poets/ravish-nadeem?lang=ur
روش صدیقی 	/poets/ravish-siddiqi?lang=ur
رضا امروہوی 	/poets/raza-amrohvi?lang=ur
رضا اشک 	/poets/raza-ashk?lang=ur
رضا عظیم آبادی 	/poets/raza-azimabadi?lang=ur
رضا ہمدانی 	/poets/raza-hamdani?lang=ur
رضا جونپوری 	/poets/raza-jaunpuri?lang=ur
رضا لکھنوی 	/poets/raza-lakhnavi?lang=ur
رضا مورانوی 	/poets/raza-mauranvi?lang=ur
رضا مراد آبادی 	/poets/raza-muradabadi?lang=ur
رضا نقوی واہی 	/poets/raza-naqvi-vahi?lang=ur
رضی اختر شوق 	/poets/razi-akhtar-shauq?lang=ur
رضی مجتبی 	/poets/razi-mujtaba?lang=ur
رضی رضی الدین 	/poets/razi-raziuddin?lang=ur
رضی ترمذی 	/poets/razi-tirmizi?lang=ur
رضیہ حلیم جنگ 	/poets/razia-halim-jang?lang=ur
رازق انصاری 	/poets/raziq-ansari?lang=ur
رضیہ فصیح احمد 	/poets/raziya-faseeh-ahmad?lang=ur
رزاق عادل 	/poets/razzaq-aadil?lang=ur
رزاق افسر 	/poets/razzaq-afsar?lang=ur
رزاق ارشد 	/poets/razzaq-arshad?lang=ur
ریحان علوی 	/poets/rehan-alvi?lang=ur
ریحانہ قمر 	/poets/rehana-qamar?lang=ur
ریحانہ روحی 	/poets/rehana-roohi?lang=ur
رحمان فارس 	/poets/rehman-faris?lang=ur
رینو نیر 	/poets/renu-nayyar?lang=ur
رینو ورما 	/poets/renu-verma?lang=ur
ریاض ہانس 	/poets/riaz-hans?lang=ur
ریاض لطیف 	/poets/riaz-latif?lang=ur
ریاض مجید 	/poets/riaz-majeed?lang=ur
رفعت عباس 	/poets/rifat-abbas?lang=ur
رفعت الحسینی 	/poets/rifat-al-husaini?lang=ur
رفعت ناہید 	/poets/rifat-naheed?lang=ur
رفعت سروش 	/poets/rifat-sarosh?lang=ur
رفعت سیٹھی 	/poets/rifat-sethi?lang=ur
رفعت سلطان 	/poets/rifat-sultan?lang=ur
رفعت زمانی بیگم عصمت 	/poets/rifat-zamani-begum-ismat?lang=ur
رفعت القاسمی 	/poets/rifat-ul-qasmi?lang=ur
رند لکھنوی 	/poets/rind-lakhnavi?lang=ur
رند ساغری 	/poets/rind-saghari?lang=ur
رشی پٹیالوی 	/poets/rishi-patialvi?lang=ur
ریاست علی تاج 	/poets/riyasat-ali-taj?lang=ur
ریاضؔ خیرآبادی 	/poets/riyaz-khairabadi?lang=ur
ریاض ساغر 	/poets/riyaz-saghar?lang=ur
ریاضت علی شائق 	/poets/riyazat-ali-shaiq?lang=ur
رضوان اللہ 	/poets/rizwanullah?lang=ur
رضوان الرضا رضوان 	/poets/rizwanur-raza-rizwan?lang=ur
روبینہ فیصل 	/poets/robeena-faisal?lang=ur
روہت سونی تابشؔ 	/poets/rohit-soni-tabish?lang=ur
روحی کنجاہی 	/poets/roohi-kanjahi?lang=ur
روپ ساگر 	/poets/roop-sagar?lang=ur
رائے سرب سکھ دیوانہ 	/poets/roy-sarb-sukh-diwana?lang=ur
رخسانہ نور 	/poets/rukhsana-noor?lang=ur
رومانہ رومی 	/poets/rumana-rumi?lang=ur
ایس اے مہدی 	/poets/s-a-mehdi?lang=ur
سعادت باندوی 	/poets/saadat-bandvi?lang=ur
سعادت سعید 	/poets/saadat-saeed?lang=ur
سعد اللہ کلیم 	/poets/saadullah-kaleem?lang=ur
سعد اللہ شاہ 	/poets/saadullah-shah?lang=ur
سائل دہلوی 	/poets/saail-dehlvi?lang=ur
صبا افغانی 	/poets/saba-afghani?lang=ur
صبا اکبرآبادی 	/poets/saba-akbarabadi?lang=ur
صبا اختر 	/poets/saba-akhtar?lang=ur
صبا اکرام 	/poets/saba-ikram?lang=ur
صبا جائسی 	/poets/saba-jayasi?lang=ur
صبا نقوی 	/poets/saba-naqvi?lang=ur
صبا نصرت 	/poets/saba-nusrat?lang=ur
سبیلہ انعام صدیقی 	/poets/sabeela-inam-siddiqui?lang=ur
صبیحہ صبا 	/poets/sabiha-saba?lang=ur
صبیحہ صبا 	/poets/sabiha-saba-1?lang=ur
صابر 	/poets/sabir?lang=ur
صابر ادیب 	/poets/sabir-adeeb?lang=ur
صابر آفاقی 	/poets/sabir-afaqi?lang=ur
صابر بدر جعفری 	/poets/sabir-badr-jaafrii?lang=ur
صابر دت 	/poets/sabir-dutt?lang=ur
صابر رضا 	/poets/sabir-raza?lang=ur
صابر شاہ صابر 	/poets/sabir-shah-sabir?lang=ur
صابر وسیم 	/poets/sabir-waseem?lang=ur
صابر ظفر 	/poets/sabir-zafar?lang=ur
صابر زاہد 	/poets/sabir-zahid?lang=ur
سچن شالنی 	/poets/sachin-shalini?lang=ur
صدا انبالوی 	/poets/sada-ambalvi?lang=ur
صدف جعفری 	/poets/sadaf-jafri?lang=ur
صادق 	/poets/sadiq?lang=ur
صادقہ فاطمی 	/poets/sadiqa-fatimi?lang=ur
صادق اندوری 	/poets/sadique-indori?lang=ur
صادق نسیم 	/poets/sadique-naseem?lang=ur
سعدیہ روشن صدیقی 	/poets/sadiya-roshan-siddiqui?lang=ur
سعدیہ صفدر سعدی 	/poets/sadiya-safdar-saadi?lang=ur
سعید عاصم 	/poets/saeed-aasim?lang=ur
سعید احمد 	/poets/saeed-ahmad?lang=ur
سعید احمد اختر 	/poets/saeed-ahmad-akhtar?lang=ur
سعید اختر 	/poets/saeed-akhtar?lang=ur
سعید عارفی 	/poets/saeed-arifi?lang=ur
سعید خان 	/poets/saeed-khan?lang=ur
سعید نقوی 	/poets/saeed-naqvi?lang=ur
سعید قیس 	/poets/saeed-qais?lang=ur
سعید راہی 	/poets/saeed-rahi?lang=ur
سعید شباب 	/poets/saeed-shabab?lang=ur
سعید شارق 	/poets/saeed-shariq?lang=ur
سعیدہ جہاں مخفی 	/poets/saeeda-jahan-makhfi?lang=ur
سعید الدین  	/poets/saeeduddin?lang=ur
سعید الظفر چغتائی 	/poets/saeed-ul-zafar-chughtai?lang=ur
سعید الزماں عباسی 	/poets/saeeduzzamaan-abbasi?lang=ur
ایس اے مہدی 	/poets/s-a-mehdi?lang=ur
سعادت باندوی 	/poets/saadat-bandvi?lang=ur
سعادت سعید 	/poets/saadat-saeed?lang=ur
سعد اللہ کلیم 	/poets/saadullah-kaleem?lang=ur
سعد اللہ شاہ 	/poets/saadullah-shah?lang=ur
سائل دہلوی 	/poets/saail-dehlvi?lang=ur
صبا افغانی 	/poets/saba-afghani?lang=ur
صبا اکبرآبادی 	/poets/saba-akbarabadi?lang=ur
صبا اختر 	/poets/saba-akhtar?lang=ur
صبا اکرام 	/poets/saba-ikram?lang=ur
صبا جائسی 	/poets/saba-jayasi?lang=ur
صبا نقوی 	/poets/saba-naqvi?lang=ur
صبا نصرت 	/poets/saba-nusrat?lang=ur
سبیلہ انعام صدیقی 	/poets/sabeela-inam-siddiqui?lang=ur
صبیحہ صبا 	/poets/sabiha-saba?lang=ur
صبیحہ صبا 	/poets/sabiha-saba-1?lang=ur
صابر 	/poets/sabir?lang=ur
صابر ادیب 	/poets/sabir-adeeb?lang=ur
صابر آفاقی 	/poets/sabir-afaqi?lang=ur
صابر بدر جعفری 	/poets/sabir-badr-jaafrii?lang=ur
صابر دت 	/poets/sabir-dutt?lang=ur
صابر رضا 	/poets/sabir-raza?lang=ur
صابر شاہ صابر 	/poets/sabir-shah-sabir?lang=ur
صابر وسیم 	/poets/sabir-waseem?lang=ur
صابر ظفر 	/poets/sabir-zafar?lang=ur
صابر زاہد 	/poets/sabir-zahid?lang=ur
سچن شالنی 	/poets/sachin-shalini?lang=ur
صدا انبالوی 	/poets/sada-ambalvi?lang=ur
صدف جعفری 	/poets/sadaf-jafri?lang=ur
صادق 	/poets/sadiq?lang=ur
صادقہ فاطمی 	/poets/sadiqa-fatimi?lang=ur
صادق اندوری 	/poets/sadique-indori?lang=ur
صادق نسیم 	/poets/sadique-naseem?lang=ur
سعدیہ روشن صدیقی 	/poets/sadiya-roshan-siddiqui?lang=ur
سعدیہ صفدر سعدی 	/poets/sadiya-safdar-saadi?lang=ur
سعید عاصم 	/poets/saeed-aasim?lang=ur
سعید احمد 	/poets/saeed-ahmad?lang=ur
سعید احمد اختر 	/poets/saeed-ahmad-akhtar?lang=ur
سعید اختر 	/poets/saeed-akhtar?lang=ur
سعید عارفی 	/poets/saeed-arifi?lang=ur
سعید خان 	/poets/saeed-khan?lang=ur
سعید نقوی 	/poets/saeed-naqvi?lang=ur
سعید قیس 	/poets/saeed-qais?lang=ur
سعید راہی 	/poets/saeed-rahi?lang=ur
سعید شباب 	/poets/saeed-shabab?lang=ur
سعید شارق 	/poets/saeed-shariq?lang=ur
سعیدہ جہاں مخفی 	/poets/saeeda-jahan-makhfi?lang=ur
سعید الدین  	/poets/saeeduddin?lang=ur
سعید الظفر چغتائی 	/poets/saeed-ul-zafar-chughtai?lang=ur
سعید الزماں عباسی 	/poets/saeeduzzamaan-abbasi?lang=ur
صفدر خورشید 	/poets/safdar-khursheed?lang=ur
صفدر میر 	/poets/safdar-meer?lang=ur
صفدر رضا صفی 	/poets/safdar-raza-safi?lang=ur
صفدر سلیم سیال 	/poets/safdar-saleem-sial?lang=ur
صفدر صدیق رضی 	/poets/safdar-siddiq-razi?lang=ur
سفیر کاکوروی 	/poets/safeer-kakorvi?lang=ur
صفی اورنگ آبادی 	/poets/safi-aurangabadi?lang=ur
صفی لکھنوی 	/poets/safi-lakhnavi?lang=ur
صفیہ اریب 	/poets/safiya-arib?lang=ur
صفیہ شمیم 	/poets/safiya-shamim?lang=ur
ساگر جلال آبادی 	/poets/sagar-jalalabadi?lang=ur
ساغرؔ اعظمی 	/poets/saghar-azmi?lang=ur
ساغر خیامی 	/poets/saghar-khayyami?lang=ur
ساغر مہدی 	/poets/saghar-mehdi?lang=ur
ساغر نظامی 	/poets/saghar-nizami?lang=ur
ساغر صدیقی 	/poets/saghar-siddiqui?lang=ur
صغیر عالم 	/poets/sagheer-alam?lang=ur
صغیر علی مروت 	/poets/sagheer-ali-murawat?lang=ur
صغیر ملال 	/poets/sagheer-malal?lang=ur
صغیر احمد صغیر احسنی 	/poets/saghir-ahmad-saghir-ahsani?lang=ur
صغیر احمد صوفی 	/poets/saghir-ahmad-sufi?lang=ur
سحاب قزلباش 	/poets/sahab-qazalbash?lang=ur
سحر انصاری 	/poets/sahar-ansari?lang=ur
سحر محمود 	/poets/sahar-mahmood?lang=ur
صہبا اختر 	/poets/sahba-akhtar?lang=ur
صہبا لکھنوی 	/poets/sahba-lakhnavi?lang=ur
صہبا وحید 	/poets/sahba-waheed?lang=ur
صاحبہ شہریار 	/poets/sahiba-sheheryar?lang=ur
ساحل احمد 	/poets/sahil-ahmad?lang=ur
ساحر بھوپالی 	/poets/sahir-bhopali?lang=ur
ساحر دہلوی 	/poets/sahir-dehlavi?lang=ur
ساحر ہوشیار پوری 	/poets/sahir-hoshiyarpuri?lang=ur
ساحر لکھنوی 	/poets/sahir-lakhnavi?lang=ur
ساحر لدھیانوی 	/poets/sahir-ludhianvi?lang=ur
ساحر شیوی 	/poets/sahir-shevi?lang=ur
ساحر سیالکوٹی 	/poets/sahir-siyalkoti?lang=ur
صائب عاصمی 	/poets/saib-asmi?lang=ur
سعید اقبال سعدی 	/poets/said-iqbal-saadi?lang=ur
سیف علی 	/poets/saif-ali?lang=ur
سیف بجنوری 	/poets/saif-bijnori?lang=ur
سیف سہسرامی 	/poets/saif-sahsarami?lang=ur
سیف زلفی 	/poets/saif-zulfi?lang=ur
سیفی پریمی 	/poets/saifi-premi?lang=ur
سیفی سرونجی 	/poets/saifi-sironji?lang=ur
سیف الدین سیف 	/poets/saifuddin-saif?lang=ur
سیلانی سیوتے 	/poets/sailani-sevte?lang=ur
صائم جی 	/poets/saim-ji?lang=ur
صائمہ آفتاب 	/poets/saima-aftab?lang=ur
صائمہ اسما 	/poets/saima-esma?lang=ur
صائمہ جبین مہک 	/poets/saima-jabeen-mahak?lang=ur
صائمہ خیری 	/poets/saima-khairi?lang=ur
ساجد امجد 	/poets/sajid-amjad?lang=ur
ساجد اثر 	/poets/sajid-asar?lang=ur
ساجد حمید 	/poets/sajid-hameed?lang=ur
ساجد ہاشمی 	/poets/sajid-hashmi?lang=ur
ساجد پریمی 	/poets/sajid-premi?lang=ur
ساجد صدیقی لکھنوی 	/poets/sajid-siddiqi-lakhnavi?lang=ur
ساجدہ زیدی 	/poets/sajida-zaidi?lang=ur
سجاد بابر 	/poets/sajjad-babar?lang=ur
سجاد بلوچ 	/poets/sajjad-baluch?lang=ur
سجاد باقر رضوی 	/poets/sajjad-baqar-rizvi?lang=ur
سجاد شمسی 	/poets/sajjad-shamsi?lang=ur
سجاد سید 	/poets/sajjad-syed?lang=ur
سجاد ظہیر 	/poets/sajjad-zaheer?lang=ur
سخاوت شمیم 	/poets/sakhawat-shameem?lang=ur
سخی لکھنوی 	/poets/sakhi-lakhnvi?lang=ur
صلاح الدین محمود 	/poets/salahuddin-mahmood?lang=ur
صلاح الدین محمد 	/poets/salahuddin-mohammad?lang=ur
صلاح الدین ندیم 	/poets/salahuddin-nadeem?lang=ur
صلاح الدین نیر 	/poets/salahuddin-nayyar?lang=ur
صلاح الدین پرویز 	/poets/salahuddin-parvez?lang=ur
سلام ؔمچھلی شہری 	/poets/salam-machhli-shahri?lang=ur
سلام سندیلوی 	/poets/salam-sandelvi?lang=ur
سلیم احمد 	/poets/saleem-ahmed?lang=ur
سلیم انصاری 	/poets/saleem-ansari?lang=ur
سلیم بیتاب 	/poets/saleem-betab?lang=ur
سلیم فراز 	/poets/saleem-faraz?lang=ur
سلیم فوز 	/poets/saleem-fauz?lang=ur
سلیم فگار 	/poets/saleem-figar?lang=ur
سلیم کاشیر 	/poets/saleem-kashir?lang=ur
سلیم کوثر 	/poets/saleem-kausar?lang=ur
سلیم محی الدین 	/poets/saleem-muhiuddin?lang=ur
سلیم رضا ریوا 	/poets/saleem-raza-rewa?lang=ur
سلیم سرفراز 	/poets/saleem-sarfaraz?lang=ur
سلیم شاہد 	/poets/saleem-shahid?lang=ur
سلیم شہزاد 	/poets/saleem-shahzad?lang=ur
سلیم شیرازی 	/poets/saleem-shirazi?lang=ur
سلیم صدیقی 	/poets/saleem-siddiqui?lang=ur
سلیم الرحمن 	/poets/saleem-ur-rahman?lang=ur
سالک دہلوی 	/poets/salik-dehlvi?lang=ur
سالک لکھنوی 	/poets/salik-lakhnavi?lang=ur
سلیم ساگر 	/poets/salim-sagar?lang=ur
سالم سلیم 	/poets/salim-saleem?lang=ur
سالم شجاع انصاری 	/poets/salim-shuja-ansari?lang=ur
سلمیٰ شاہین 	/poets/salma-shaheen-1?lang=ur
سلمان اختر 	/poets/salman-akhtar?lang=ur
سلمان انصاری 	/poets/salman-ansari?lang=ur
سلمان سعید 	/poets/salman-saeed?lang=ur
سلمان ثروت 	/poets/salman-sarwat?lang=ur
سلمان صدیقی 	/poets/salman-siddiqui?lang=ur
سلمان ظفر 	/poets/salman-zafar?lang=ur
صمد انصاری 	/poets/samad-ansari?lang=ur
ثمینہ راجہ 	/poets/sameena-raja?lang=ur
ثمیر کبیر 	/poets/sameer-kabeer?lang=ur
ثناء اللہ فراق 	/poets/sanaullah-firaq?lang=ur
ثناء اللہ ظہیر 	/poets/sanaullah-zaheer?lang=ur
سندیپ کول نادم 	/poets/sandeep-koul-nadim?lang=ur
سنجے مصرا شوق 	/poets/sanjay-mishra-shauq?lang=ur
سنجیو آریہ 	/poets/sanjiv-arya?lang=ur
سنتوش کھروڑکر 	/poets/santosh-khirvadkar?lang=ur
ساقی امروہوی 	/poets/saqi-amrohvi?lang=ur
ساقی فاروقی 	/poets/saqi-faruqi?lang=ur
ثاقب کانپوری 	/poets/saqib-kanpuri?lang=ur
ثاقب لکھنوی 	/poets/saqib-lakhnavi?lang=ur
ثاقب رزمی 	/poets/saqib-razmi?lang=ur
سارا شگفتہ 	/poets/sara-shagufta?lang=ur
سرسوتی سرن کیف 	/poets/saraswati-saran-kaif?lang=ur
سردار انجم 	/poets/sardar-anjum?lang=ur
سردار آصف 	/poets/sardar-asif?lang=ur
سردار ایاغ 	/poets/sardar-ayagh?lang=ur
سردار گینڈا سنگھ مشرقی 	/poets/sardar-genda-singh-mashriqi?lang=ur
سردار پنچھی 	/poets/sardar-panchhi?lang=ur
سردار سلیم 	/poets/sardar-saleem?lang=ur
سردار سوز 	/poets/sardar-soz?lang=ur
سریر کابری 	/poets/sareer-kabiri?lang=ur
سرفراز ابد 	/poets/sarfaraz-abad?lang=ur
سرفراز عامر 	/poets/sarfaraz-amir?lang=ur
سرفراز شاہد 	/poets/sarfaraz-shahid?lang=ur
سرفراز سید 	/poets/sarfaraz-syed?lang=ur
سرفراز آرش 	/poets/sarfraz-arish?lang=ur
سرفراز دانش 	/poets/sarfraz-danish?lang=ur
سرفراز خالد 	/poets/sarfraz-khalid?lang=ur
سرفراز نواز 	/poets/sarfraz-nawaz?lang=ur
سرفراز زاہد 	/poets/sarfraz-zahid?lang=ur
سرمد صہبائی 	/poets/sarmad-sahbai?lang=ur
سرشار بلند شہری 	/poets/sarshaar-buland-shahri?lang=ur
سرشار سیلانی 	/poets/sarshar-sailani?lang=ur
سرشار صدیقی 	/poets/sarshar-siddiqui?lang=ur
سرتاج عالم عابدی 	/poets/sartaj-alam-abidi?lang=ur
سرور عثمانی  	/poets/sarvar-usmani?lang=ur
ثروت حسین 	/poets/sarvat-husain?lang=ur
سرور عالم راز 	/poets/sarwar-alam-raz?lang=ur
سرور ارمان 	/poets/sarwar-arman?lang=ur
سرور مجاز 	/poets/sarwar-majaz?lang=ur
سرور نیپالی 	/poets/sarwar-nepali?lang=ur
ثروت محی الدین 	/poets/sarwat-muhiuddin?lang=ur
ثروت مختار 	/poets/sarwat-mukhtar?lang=ur
ثروت زہرا 	/poets/sarwat-zehra?lang=ur
ستار سید 	/poets/sattar-syed?lang=ur
ستیہ نند جاوا 	/poets/satya-nand-java?lang=ur
ستیہ پال آنند  	/poets/satyapal-anand?lang=ur
ستیہ پال جانباز 	/poets/satyapal-janbaz?lang=ur
سعود عثمانی 	/poets/saud-usmani?lang=ur
محمد رفیع سودا 	/poets/sauda-mohammad-rafi?lang=ur
صولت زیدی 	/poets/saulat-zaidi?lang=ur
سوربھ شیکھر 	/poets/saurabh-shekhar?lang=ur
ساون شکلا 	/poets/sawan-shukla?lang=ur
سید محمد عبد الغفور شہباز 	/poets/sayad-mohammad-abdul-ghafoor-shahbaz?lang=ur
سید انجم جعفری 	/poets/sayed-anjum-jafri?lang=ur
سید ایاز محمود 	/poets/sayed-ayaz-mahmood?lang=ur
سید مہدی حسین مہدی 	/poets/sayed-mehdi-hussain-mehdi?lang=ur
سید نصیر شاہ 	/poets/sayed-naseer-shah?lang=ur
سید صفی حسن 	/poets/sayed-safi-hasan?lang=ur
سید ضیا علوی 	/poets/sayed-zia-alvi?lang=ur
سائل عمران 	/poets/sayil-imran?lang=ur
سید عاشور کاظمی 	/poets/sayyad-ashoor-kazmi?lang=ur
سید اعجاز احمد رضوی 	/poets/sayyad-ejaz-ahmad-rizwi?lang=ur
سید نصرت زیدی 	/poets/sayyad-nusrat-zaidi?lang=ur
سید ساجد 	/poets/sayyad-sajid?lang=ur
سید ظہیر الدین ظہیر 	/poets/sayyad-zahiruddin-zaheer?lang=ur
سیدہ عرشیہ حق 	/poets/sayyada-arshia-haq?lang=ur
سید تابش الوری 	/poets/sayyadtabish-alwari?lang=ur
سیما غزل 	/poets/seema-ghazal?lang=ur
سیما گپتا 	/poets/seema-gupta?lang=ur
سیما نقوی 	/poets/seema-naqvi?lang=ur
سیما شکیب 	/poets/seema-shakeb?lang=ur
سیما شرما میرٹھی 	/poets/seema-sharma-meeruthi?lang=ur
سیما شرما سرحد 	/poets/seema-sharma-sarhad?lang=ur
سیماب اکبرآبادی 	/poets/seemab-akbarabadi?lang=ur
سیماب بٹالوی 	/poets/seemab-batalvi?lang=ur
سیماب سلطانپوری 	/poets/seemab-sultanpuri-1?lang=ur
سیماب ظفر 	/poets/seemab-zafar?lang=ur
سیمان نوید 	/poets/seeman-naved?lang=ur
س۔ ش۔ عالم 	/poets/seen-sheen-alam?lang=ur
سحر عشق آبادی 	/poets/sehr-ishqabadi?lang=ur
شاد عارفی 	/poets/shaad-aarfi?lang=ur
شاد امرتسری 	/poets/shaad-amritsarii?lang=ur
شان الحق حقی 	/poets/shaanul-haq-haqqi?lang=ur
شاعر لکھنوی 	/poets/shaayar-lakhnavi?lang=ur
شباب 	/poets/shabab?lang=ur
شباب للت 	/poets/shabab-lalit?lang=ur
شبانہ یوسف 	/poets/shabana-yousaf?lang=ur
شبانہ زیدی شبین 	/poets/shabana-zaidi-shabeen?lang=ur
شبیر ناقد 	/poets/shabbir-naqid?lang=ur
شبیر نازش 	/poets/shabbir-nazish?lang=ur
شبیر شاہد 	/poets/shabbir-shahid?lang=ur
شبی فاروقی 	/poets/shabi-farooqui?lang=ur
شبنم عشائی 	/poets/shabnam-ashai?lang=ur
شبنم مناوری 	/poets/shabnam-munavari?lang=ur
شبنم نقوی 	/poets/shabnam-naqvi?lang=ur
شبنم رومانی 	/poets/shabnam-rumani?lang=ur
شبنم شکیل 	/poets/shabnam-shakeel?lang=ur
شبنم وحید 	/poets/shabnam-waheed?lang=ur
شاد عظیم آبادی 	/poets/shad-azimabadi?lang=ur
شاد بلگوی 	/poets/shad-bilgavi?lang=ur
شاد لکھنوی 	/poets/shad-lakhnavi?lang=ur
شاد نوحی 	/poets/shad-nohi?lang=ur
شاداب الفت 	/poets/shadab-ulfat?lang=ur
شادان احسن مارہروی 	/poets/shadan-ahsan-marahravi?lang=ur
شاداں اندوری 	/poets/shadan-indauri?lang=ur
شاعر فتح پوری 	/poets/shaer-fatahpuri?lang=ur
شفق عماد پوری 	/poets/shafaq-imadpuri?lang=ur
شفق سوپوری 	/poets/shafaq-sopori?lang=ur
شفیق عباس 	/poets/shafeeq-abbas?lang=ur
شفیع عقیل 	/poets/shafi-aqil?lang=ur
شفیع ضامن 	/poets/shafi-zamin?lang=ur
شفیق اعظمی 	/poets/shafiq-aazmi?lang=ur
شفیق احمد 	/poets/shafiq-ahmad?lang=ur
شفیق آصف 	/poets/shafiq-asif?lang=ur
شفیق دہلوی 	/poets/shafiq-dehlvi?lang=ur
شفیق فاطمہ شعریٰ 	/poets/shafiq-fatima-shera?lang=ur
شفیق جونپوری 	/poets/shafiq-jaunpuri?lang=ur
شفیق خلش 	/poets/shafiq-khalish?lang=ur
شفیق رامپوری 	/poets/shafiq-rampuri?lang=ur
شفیق سلیمی 	/poets/shafiq-saleemi?lang=ur
شفیع اللہ راز 	/poets/shafiullah-raz?lang=ur
شفقت بٹالوی 	/poets/shafqat-batalvi?lang=ur
شفقت کاظمی 	/poets/shafqat-kazmi?lang=ur
شفقت سیٹھی 	/poets/shafqat-sethi?lang=ur
شفقت تنویر مرزا 	/poets/shafqat-tanveer-mirza?lang=ur
شاغل قادری 	/poets/shaghil-qadri?lang=ur
شگفتہ الطاف 	/poets/shagufta-altaf?lang=ur
شگفتہ طلعت سیما 	/poets/shagufta-talat-seema?lang=ur
شگفتہ یاسمین 	/poets/shagufta-yasmeen?lang=ur
شاہ آثم 	/poets/shah-aasim?lang=ur
شاہ دین ہمایوں  	/poets/shah-deen-humayun?lang=ur
شاہ حسین نہری 	/poets/shah-husain-nahri?lang=ur
شاہ جی علی 	/poets/shah-ji-ali?lang=ur
شاہ کمال الدین کمال 	/poets/shah-kamaluddin-kamal?lang=ur
شاہ نصیر 	/poets/shah-naseer?lang=ur
شاہنواز زیدی 	/poets/shah-nawaz-zaidi?lang=ur
شاہ واقف 	/poets/shah-waqif?lang=ur
شہاب اختر 	/poets/shahab-akhtar?lang=ur
شہاب اشرف 	/poets/shahab-ashraf?lang=ur
شہاب جعفری 	/poets/shahab-jafri?lang=ur
شہاب صفدر 	/poets/shahab-safdar?lang=ur
شہاب سرمدی 	/poets/shahab-sarmadi?lang=ur
شہاب الدین ثاقب 	/poets/shahabuddin-saqib?lang=ur
شاہانہ شیریں 	/poets/shahana-shirin?lang=ur
شہباز خواجہ  	/poets/shahbaz-khwaja?lang=ur
شہباز ندیم ضیائی 	/poets/shahbaz-nadeem-ziai?lang=ur
شہباز رضوی 	/poets/shahbaz-rizwi?lang=ur
شاہین عباس 	/poets/shaheen-abbas?lang=ur
شاہین بدر 	/poets/shaheen-badr?lang=ur
شاہین غازی پوری 	/poets/shaheen-gazipuri?lang=ur
شاہین اقبال اثر 	/poets/shaheen-iqbal-asar?lang=ur
شاہین مفتی 	/poets/shaheen-mufti?lang=ur
شاہین صدیقی 	/poets/shaheen-siddiqui?lang=ur
شاہد احمد شعیب 	/poets/shahid-ahmad-shoaib?lang=ur
شاہد اختر 	/poets/shahid-akhtar?lang=ur
شاہد عزیز 	/poets/shahid-aziz?lang=ur
شاہد بھوپالی 	/poets/shahid-bhopali?lang=ur
شاہد فرید 	/poets/shahid-fareed?lang=ur
شاہد غازی 	/poets/shahid-ghazi?lang=ur
شاہد عشقی 	/poets/shahid-ishqi?lang=ur
شاہد جمال 	/poets/shahid-jamal?lang=ur
شاہد جمیل 	/poets/shahid-jameel?lang=ur
شاہد کبیر 	/poets/shahid-kabir?lang=ur
شاہد کلیم 	/poets/shahid-kaleem?lang=ur
شاہد کمال 	/poets/shahid-kamal?lang=ur
شاہد لطیف 	/poets/shahid-latif?lang=ur
شاہد ماہلی 	/poets/shahid-mahuli?lang=ur
شاہد ملک 	/poets/shahid-malik?lang=ur
شاہد میر 	/poets/shahid-meer?lang=ur
شاہد نعیم 	/poets/shahid-naeem?lang=ur
شاہد شیدائی 	/poets/shahid-shaidai?lang=ur
شاہد ذکی 	/poets/shahid-zaki?lang=ur
شاہدہ حسن 	/poets/shahida-hasan?lang=ur
شاہدہ لطیف 	/poets/shahida-lateef?lang=ur
شاہدہ تبسم 	/poets/shahida-tabassum?lang=ur
شاہجہاں بانو یاد 	/poets/shahjahan-bano-yaad?lang=ur
شہنواز زیدی 	/poets/shahnawaz-zaidi?lang=ur
شہناز مزمل 	/poets/shahnaz-muzammil?lang=ur
شہناز نبی 	/poets/shahnaz-nabi?lang=ur
شہناز نور 	/poets/shahnaz-noor?lang=ur
شہود عالم آفاقی 	/poets/shahood-alam-aafaqi?lang=ur
شہرام سرمدی 	/poets/shahram-sarmadi?lang=ur
شہریار 	/poets/shahryar?lang=ur
شہزاد احمد 	/poets/shahzad-ahmad?lang=ur
شہزاد انجم برہانی 	/poets/shahzad-anjum-burhani?lang=ur
شہزاد حسن 	/poets/shahzad-hasan?lang=ur
شہزاد حسین سائل 	/poets/shahzad-husain-saail?lang=ur
شہزاد نیر 	/poets/shahzad-nayar?lang=ur
شہزاد قیس 	/poets/shahzad-qais?lang=ur
شہزاد قمر 	/poets/shahzad-qamar?lang=ur
شیدا انبالوی 	/poets/shaida-ambalvi?lang=ur
شیدا رومانی 	/poets/shaida-rumani?lang=ur
شیخ عبداللطیف تپش 	/poets/shaikh-abdul-lateef-tapish?lang=ur
شیخ میر بخش مسرور 	/poets/shaikh-meer-bakhsh-masroor?lang=ur
شیخ محمد روشن جوشش لکھنوی 	/poets/shaikh-mohammad-roshan-joshish-lakhnavi?lang=ur
شیخ ظہور الدین حاتم 	/poets/shaikh-zahuruddin-hatim?lang=ur
شائق مظفر پوری 	/poets/shaiq-muzaffarpuri?lang=ur
شائستہ حبیب 	/poets/shaista-habeeb?lang=ur
شائستہ مفتی 	/poets/shaista-mufti?lang=ur
شائستہ سحر 	/poets/shaista-sahar?lang=ur
شائستہ یوسف 	/poets/shaista-yusuf?lang=ur
شکیب ایاز 	/poets/shakeb-ayaz?lang=ur
شکیب بنارسی 	/poets/shakeb-banarsi?lang=ur
شکیب جلالی 	/poets/shakeb-jalali?lang=ur
شکیل اعظمی 	/poets/shakeel-azmi?lang=ur
شکیل بدایونی 	/poets/shakeel-badayuni-3?lang=ur
شکیل گوالیاری 	/poets/shakeel-gwaliari?lang=ur
شکیل جعفری 	/poets/shakeel-jafri?lang=ur
شکیل جمالی 	/poets/shakeel-jamali?lang=ur
شکیل جاذب 	/poets/shakeel-jazib?lang=ur
شکیل مظہری 	/poets/shakeel-mazhari?lang=ur
شکیل نشتر 	/poets/shakeel-nashtar?lang=ur
شکیل سروش 	/poets/shakeel-sarosh?lang=ur
شکیل شمسی 	/poets/shakeel-shamsi?lang=ur
شکیلہ بانو 	/poets/shakeela-bano?lang=ur
 شاکر عنایتی 	/poets/shakir-inayati?lang=ur
شاکر کلکتوی 	/poets/shakir-kalkattvi?lang=ur
شاکر خلیق 	/poets/shakir-khaliq?lang=ur
شاکر کنڈان 	/poets/shakir-kundan?lang=ur
شاکر میرٹھی 	/poets/shakir-merathi?lang=ur
شکور جاوید 	/poets/shakur-javed?lang=ur
شام رضوی 	/poets/sham-rizvi?lang=ur
شمیم عباس 	/poets/shamim-abbas?lang=ur
شمیم علوی  	/poets/shamim-alvi?lang=ur
شمیم انور 	/poets/shamim-anwar?lang=ur
شمیم آذر 	/poets/shamim-azar?lang=ur
شمیم فاروقی 	/poets/shamim-farooqui?lang=ur
شمیم فتح پوری 	/poets/shamim-fatehpuri?lang=ur
شمیم حنفی 	/poets/shamim-hanafi?lang=ur
شمیم ہاشمی 	/poets/shamim-hashimi?lang=ur
شمیم جے پوری 	/poets/shamim-jaipuri?lang=ur
شمیم کرہانی 	/poets/shamim-karhani?lang=ur
شمیم قاسمی 	/poets/shamim-qasmi?lang=ur
شمیم روش 	/poets/shamim-ravish?lang=ur
شمیم طارق 	/poets/shamim-tariq?lang=ur
شمس فریدی 	/poets/shams-fareedi?lang=ur
شمس فرخ آبادی  	/poets/shams-farrukhabadi?lang=ur
شمس اٹاوی 	/poets/shams-itawi?lang=ur
شمس رمزی 	/poets/shams-ramzi?lang=ur
شمس تبریزی 	/poets/shams-tabrezi?lang=ur
شمس زبیری 	/poets/shams-zubairi?lang=ur
شمشاد سحر 	/poets/shamshad-shahar?lang=ur
شمشیر حیدر 	/poets/shamshir-haidar?lang=ur
شمس تسنیم 	/poets/shamsi-tasneem?lang=ur
شمس النساء بیگم شرمؔ 	/poets/shams-un-nisa-begum-sharm?lang=ur
شمس الرحمن فاروقی 	/poets/shamsur-rahman-faruqi?lang=ur
شان بھارتی 	/poets/shan-bharti?lang=ur
شناور اسحاق 	/poets/shanawar-ishaq?lang=ur
شنکر لال شنکر 	/poets/shankar-lal-shankar?lang=ur
شانتی لال ملہوترہ 	/poets/shanti-lal-malhotra?lang=ur
شرف مجددی 	/poets/sharaf-mujaddidi?lang=ur
شرر فتح پوری 	/poets/sharar-fatehpuri?lang=ur
شریف احمد شریف 	/poets/shareef-ahmad-shareef?lang=ur
شریف منور 	/poets/shareef-munawwar?lang=ur
شارب لکھنوی 	/poets/sharib-lakhnavi?lang=ur
شارب مورانوی 	/poets/sharib-mauranwi?lang=ur
شریف کنجاہی 	/poets/sharif-kunjahi?lang=ur
شارق عدیل 	/poets/shariq-adeel?lang=ur
شارق بلیاوی 	/poets/shariq-balyavi?lang=ur
شارق ایرایانی 	/poets/shariq-irayani?lang=ur
شارق جمال 	/poets/shariq-jamal?lang=ur
شارق کیفی 	/poets/shariq-kaifi?lang=ur
شرما تاثیر 	/poets/sharmaa-taseer?lang=ur
شرون کمار ورما 	/poets/sharvan-kumar-varma?lang=ur
شاطر امرتسری 	/poets/shatir-amritsari?lang=ur
شاطرحکیمی 	/poets/shatir-hakeemi?lang=ur
شوکت عابدی 	/poets/shaukat-abidi?lang=ur
شوکت فہمی 	/poets/shaukat-fahmi?lang=ur
شوکت ہاشمی 	/poets/shaukat-hashmi?lang=ur
شوکت کاظمی 	/poets/shaukat-kazmi?lang=ur
شوکت مہدی 	/poets/shaukat-mehdi?lang=ur
شوکت پردیسی 	/poets/shaukat-pardesi?lang=ur
شوکت تھانوی 	/poets/shaukat-thanvi?lang=ur
شوکت واسطی 	/poets/shaukat-wasti?lang=ur
شوق بہرائچی 	/poets/shauq-bahraichi?lang=ur
شوق بجنوری 	/poets/shauq-bijnori?lang=ur
شوق دہلوی مکی  	/poets/shauq-dehlvi-makki?lang=ur
شوق جالندھری 	/poets/shauq-jalandhari?lang=ur
شوق ماہری 	/poets/shauq-mahri?lang=ur
شوق قدوائی 	/poets/shauq-qidvai?lang=ur
شوق سالکی 	/poets/shauq-salki?lang=ur
شایان قریشی 	/poets/shayan-quraishi?lang=ur
شاعر علی شاعر 	/poets/shayar-ali-shayar?lang=ur
شاذ تمکنت 	/poets/shaz-tamkanat?lang=ur
شاذیہ ناز 	/poets/shazia-naaz?lang=ur
شاذیہ اکبر 	/poets/shaziya-akbar?lang=ur
شین کاف نظام 	/poets/sheen-kaaf-nizam-3?lang=ur
شیریں احمد 	/poets/sheerin-ahmad?lang=ur
شیث محمد اسماعیل اعظمی 	/poets/sheesh-mohammad-ismail-azmi?lang=ur
مصطفیٰ خاں شیفتہ 	/poets/shefta-mustafa-khan?lang=ur
شہپر رسول 	/poets/shehpar-rasool?lang=ur
شہزاد رضا لمس 	/poets/shehzad-raza-lams?lang=ur
شیخ علی بخش بیمار 	/poets/sheikh-bimar-ali-bakhsh?lang=ur
شیخ ابراہیم ذوقؔ 	/poets/sheikh-ibrahim-zauq?lang=ur
شیر افضل جعفری 	/poets/sher-afzal-jafri?lang=ur
شیر محمد خاں ایمان 	/poets/sher-mohammad-khan-iman?lang=ur
شیر سنگھ ناز دہلوی 	/poets/sher-singh-naaz-dehlvi?lang=ur
شعری بھوپالی 	/poets/sheri-bhopali?lang=ur
شیون بجنوری 	/poets/shevan-bijnauri?lang=ur
شبلی نعمانی 	/poets/shibli-nomani?lang=ur
شفا کجگاؤنوی 	/poets/shifa-kajgavnwi?lang=ur
شیو چرن داس گوئل ضبط 	/poets/shiv-charan-das-goyal-zabt?lang=ur
شیو دیال سحاب 	/poets/shiv-dayal-sahab?lang=ur
شو رتن لال برق پونچھوی 	/poets/shiv-ratan-lal-barq-punchhwi?lang=ur
شیو کمار بلگرامی 	/poets/shivkumar-bilgarami?lang=ur
شمشاد شاد 	/poets/shmashad-shad?lang=ur
شعیب احمد میرٹھی ندرت 	/poets/shoaib-ahmad-merathi-nudrat?lang=ur
شعیب بن عزیز 	/poets/shoaib-bin-aziz?lang=ur
شعیب نظام 	/poets/shoaib-nizam?lang=ur
شوبھا ککل 	/poets/shobha-kukkal?lang=ur
شہرت بخاری 	/poets/shohrat-bukhari?lang=ur
شعیب بخاری 	/poets/shoib-bukhari?lang=ur
شعلہؔ علی گڑھ 	/poets/shola-aligarhi?lang=ur
شعلہ ہسپانوی 	/poets/shola-haspanvi?lang=ur
شعلہ کراروی 	/poets/shola-kararvi?lang=ur
شوق مرادابادی 	/poets/shoque-moradabadi?lang=ur
شورش کاشمیری 	/poets/shorish-kashmiri?lang=ur
شوزیب کاشر 	/poets/shozeb-kashir?lang=ur
شبہ طراز 	/poets/shubh-taraz?lang=ur
شبھا شکلا مشرا ادھر 	/poets/shubha-shukla-mishra-adhar?lang=ur
شجاع 	/poets/shuja?lang=ur
شجاع خاور 	/poets/shuja-khaavar?lang=ur
شجاعت علی راہی 	/poets/shujaat-ali-rahi?lang=ur
شجاعت اقبال 	/poets/shujaat-iqbal?lang=ur
شمائلہ بہزاد 	/poets/shumaila-bahzad?lang=ur
شمامہ افق  new	/poets/shumama-ufuq?lang=ur
شعور بلگرامی 	/poets/shuoor-balgirami?lang=ur
شیام سندر نندا نور 	/poets/shyam-sundar-nanda-noor?lang=ur
شیام سندر لال برق 	/poets/shyam-sunder-lal-barq?lang=ur
سبط احمد 	/poets/sibt-ahmad?lang=ur
سبط علی صبا 	/poets/sibt-ali-saba?lang=ur
سبطین اخگر 	/poets/sibtain-akhgar?lang=ur
صدیق احمد نظامی 	/poets/siddiq-ahmad-nizami?lang=ur
صدیق شاہد 	/poets/siddiq-shahid?lang=ur
صدیقہ شبنم 	/poets/siddiqa-shabnam?lang=ur
صدیق افغانی 	/poets/siddique-afghani?lang=ur
صدیق کلیم 	/poets/siddique-kaleem?lang=ur
صدیق مجیبی 	/poets/siddique-mujibi?lang=ur
صدیق عمر 	/poets/siddique-umar?lang=ur
سدرہ سحر عمران 	/poets/sidra-sahar-imran?lang=ur
سکندر علی وجد 	/poets/sikandar-ali-wajd?lang=ur
سکندر حیات خیال 	/poets/sikandar-hayat-khayal?lang=ur
سراج اجملی  	/poets/siraj-ajmali?lang=ur
ؔسراج عالم زخمی 	/poets/siraj-alam-zakhmi?lang=ur
سراج اورنگ آبادی 	/poets/siraj-aurangabadi?lang=ur
سراج فیصل خان 	/poets/siraj-faisal-khan?lang=ur
سراج لکھنوی 	/poets/siraj-lakhnavi?lang=ur
سراج منیر 	/poets/siraj-muneer?lang=ur
سراج الدین ظفر 	/poets/sirajuddin-zafar?lang=ur
سیا سچدیو 	/poets/siya-sachdev?lang=ur
سوہن راہی 	/poets/sohan-rahi?lang=ur
سون روپا وشال 	/poets/sonroopa-vishal?lang=ur
سوز بریلوی 	/poets/soz-barelvi?lang=ur
سوز نجیب آبادی 	/poets/soz-najeebabadi?lang=ur
سبحان اسد 	/poets/subhan-asad?lang=ur
سبھاش پاٹھک ضیا 	/poets/subhash-pathak-ziya?lang=ur
سبودھ لال ساقی 	/poets/subodh-lal-saqi?lang=ur
سدرشن فاخر 	/poets/sudarshan-faakhir?lang=ur
سدرشن کمار وگل 	/poets/sudarshan-kumar-vuggal?lang=ur
سدیش کمار مہر 	/poets/sudesh-kumar-mehr?lang=ur
سودھانشو فردوس 	/poets/sudhanshu-firdaus?lang=ur
سدھیر بمولا 	/poets/sudhir-bamola?lang=ur
صوفی تبسم 	/poets/sufi-tabassum?lang=ur
صوفیہ انجم تاج 	/poets/sufia-anjum-taj?lang=ur
صغریٰ عالم 	/poets/sughra-alam?lang=ur
صغری سبزواری 	/poets/sughra-sabzwari?lang=ur
صغری صدف 	/poets/sughra-sadaf?lang=ur
سہا مجددی 	/poets/suha-mujaddadi?lang=ur
سہیل احمد خان 	/poets/suhail-ahmad-khan?lang=ur
سہیل احمد زیدی 	/poets/suhail-ahmed-zaidi?lang=ur
سہیل اختر 	/poets/suhail-akhtar?lang=ur
سہیل کاکوروی 	/poets/suhail-kakorvi?lang=ur
سہیل راشد 	/poets/suhail-rashid?lang=ur
سہیل ثانی 	/poets/suhail-sani?lang=ur
سلیمان آصف 	/poets/sulaiman-aasif?lang=ur
سلیمان احمد مانی 	/poets/sulaiman-ahmad-mani?lang=ur
سلیمان اریب 	/poets/sulaiman-areeb?lang=ur
سلیمان جاذب 	/poets/sulaiman-jazib?lang=ur
سلیمان خطیب 	/poets/sulaiman-khateeb?lang=ur
سلیمان خمار 	/poets/suleman-khumar?lang=ur
سلطان اختر 	/poets/sultan-akhtar?lang=ur
سلطان غوری 	/poets/sultan-ghauri?lang=ur
سلطان نظامی 	/poets/sultan-nizami?lang=ur
سلطان رشک 	/poets/sultan-rashk?lang=ur
سلطان صبروانی 	/poets/sultan-sabr-wani?lang=ur
سلطان شاہد 	/poets/sultan-shahid?lang=ur
سلطان سبحانی 	/poets/sultan-subhani?lang=ur
سلطان سکون 	/poets/sultan-sukoon?lang=ur
سلطان فاروقی 	/poets/sultanul-hasan-farooqi?lang=ur
سمن ڈھینگرا دگل 	/poets/suman-dhingra-duggal?lang=ur
سنیل آفتاب 	/poets/sunil-aftab?lang=ur
سنیل کمار جشن 	/poets/sunil-kumar-jashn?lang=ur
ثریا عباس 	/poets/suraiya-abbas?lang=ur
سورج نرائن 	/poets/suraj-narayan?lang=ur
سورج نرائن مہر 	/poets/suraj-narayan-meher?lang=ur
سورج تنویر 	/poets/suraj-tanveer?lang=ur
سریندر پنڈت سوز 	/poets/surender-pandit-soz?lang=ur
سریندر شجر 	/poets/surender-shajar?lang=ur
سرور انبالوی 	/poets/suroor-ambalvi?lang=ur
سرور بارہ بنکوی 	/poets/suroor-barabankvi?lang=ur
سرور جہاں آبادی 	/poets/suroor-jahanabadi?lang=ur
سرور کامران 	/poets/suroor-kamran?lang=ur
سوریا بھانو گپت 	/poets/suryabhanu-gupt?lang=ur
صالح ندیم 	/poets/swaleh-nadeem?lang=ur
سوپنل تیواری 	/poets/swapnil-tiwari?lang=ur
سید عابد علی عابد 	/poets/syed-aabid-ali-aabid?lang=ur
سید آغا علی مہر 	/poets/syed-agha-ali-mehr?lang=ur
سید احمد شمیم 	/poets/syed-ahmed-shameem?lang=ur
سید احسن جاوید 	/poets/syed-ahsan-javed?lang=ur
سید امیر حسن مارہروی دلیر 	/poets/syed-ameer-hasan-marharvi-diler?lang=ur
سید امین اشرف 	/poets/syed-amin-ashraf?lang=ur
سید امین الحسن موہانی بسمل 	/poets/syed-aminul-hasan-mohani-bismil?lang=ur
سید انوار احمد 	/poets/syed-anwar-ahmad?lang=ur
سید عارف 	/poets/syed-arif?lang=ur
'سید عارف علی ' عارف 	/poets/syed-arif-ali-arif?lang=ur
سید بشیر حسین بشیر 	/poets/syed-bashir-husain-bashir?lang=ur
سید باسط حسین ماہر لکھنوی 	/poets/syed-basit-hussain-mahir-lakhnavi?lang=ur
سید فیضی 	/poets/syed-faizi?lang=ur
سید فرزند احمد صفیر 	/poets/syed-farzand-ahmad-safeer?lang=ur
سید فضل المتین 	/poets/syed-fazlul-mateen?lang=ur
سید حبیب 	/poets/syed-habeeb?lang=ur
سید حامد 	/poets/syed-hamid?lang=ur
سید اقبال گیلانی 	/poets/syed-iqbal-gilani?lang=ur
سید اقبال رضوی شارب 	/poets/syed-iqbal-rizvi-sharib?lang=ur
سید جمیل مدنی 	/poets/syed-jameel-madni?lang=ur
سید کاشف رضا 	/poets/syed-kashif-raza?lang=ur
سید کاظم علی شوکت بلگرامی 	/poets/syed-kazim-ali-shaukat-bilgiraamii?lang=ur
سید محمود عالم رہبر 	/poets/syed-mahmood-alam-rahbar?lang=ur
سید منظور حیدر 	/poets/syed-manzoor-haidar?lang=ur
سید مظہر گیلانی 	/poets/syed-mazhar-gilani?lang=ur
سید مظہر جمیل 	/poets/syed-mazhar-jameel?lang=ur
سید معراج جامی 	/poets/syed-meraj-jami?lang=ur
سید محمد عسکری عارف 	/poets/syed-mohammad-askari-arif?lang=ur
سید محمد جعفری 	/poets/syed-mohammad-jafri?lang=ur
سید محمد ظفر اشک سنبھلی 	/poets/syed-mohammad-zafar-ashk-sanbhali?lang=ur
سید مبارک شاہ 	/poets/syed-mubarak-shah?lang=ur
سید مبین علوی خیرآبادی 	/poets/syed-mubeen-alvi-khairabadi?lang=ur
سید منیر 	/poets/syed-muneer?lang=ur
سید نواب حیدر نقوی راہی 	/poets/syed-nawab-haider-naqvi-rahi?lang=ur
سید نظیر حسن سخا دہلوی 	/poets/syed-nazeer-hasan-sakha-dehlavi?lang=ur
سید پرویز 	/poets/syed-parvez?lang=ur
سید رضا 	/poets/syed-raza?lang=ur
سید صادق علی حسین 	/poets/syed-sadiq-ali-haseen?lang=ur
سید صغیر صفی 	/poets/syed-sagheer-safi?lang=ur
سید سجاد 	/poets/syed-sajjad?lang=ur
سید شفق شاہ چشتی 	/poets/syed-shafaq-shah-chishti?lang=ur
سید شکیل دسنوی 	/poets/syed-shakeel-desnavi?lang=ur
سید صدیق حسن 	/poets/syed-siddiq-hasan?lang=ur
سید تمجید حیدر تمجید 	/poets/syed-tamjeed-haider-tamjeed?lang=ur
سید تسلیم حیدر قمر 	/poets/syed-taslim-haider-qamar?lang=ur
سید یوسف علی خاں ناظم 	/poets/syed-yusuf-ali-khan-nazim?lang=ur
سید ضمیر جعفری 	/poets/syed-zameer-jafri?lang=ur
سیدہ کوثر منور شرقپوری 	/poets/syeda-kauzar-munawar-sharqpuri?lang=ur
سیدہ نفیس بانو شمع 	/poets/syeda-nafis-bano-shama?lang=ur
سیدہ شانِ معراج 	/poets/syeda-shan-e-meraj?lang=ur
سیدہ خالدہ ضیا 	/poets/syeda-ziya-khalida?lang=ur
تعشق لکھنوی 	/poets/taashshuq-lakhnavi?lang=ur
تاب اسلم 	/poets/tab-aslam?lang=ur
تاباں عبد الحی 	/poets/taban-abdul-hai?lang=ur
غلام ربانی تاباںؔ 	/poets/taban-ghulam-rabbani?lang=ur
تبسم کاشمیری 	/poets/tabassum-kashmiri?lang=ur
تبسم رضوی 	/poets/tabassum-rizvi?lang=ur
تابش دہلوی 	/poets/tabish-dehlvi?lang=ur
تابش کمال 	/poets/tabish-kamal?lang=ur
تابش کانپوری 	/poets/tabish-kanpuri?lang=ur
تابش مہدی 	/poets/tabish-mehdi?lang=ur
تابش صدیقی 	/poets/tabish-siddiqui?lang=ur
تفضل حسین خاں کوکب دہلوی 	/poets/tafazzul-husain-khan-kaukab-dehlavi?lang=ur
تفضیل احمد 	/poets/tafzeel-ahmad?lang=ur
طاہر عدیم 	/poets/tahir-adeem?lang=ur
طاہر عظیم 	/poets/tahir-azeem?lang=ur
طاہر فراز 	/poets/tahir-faraz?lang=ur
طاہر تونسوی 	/poets/tahir-tonsvi?lang=ur
طاہرہ جبین تارا 	/poets/tahira-jabeen-tara?lang=ur
تحسین فراقی 	/poets/tahseen-firaqi?lang=ur
تہذیب حافی 	/poets/tahzeeb-hafi?lang=ur
تیمور حسن 	/poets/taimur-hasan?lang=ur
تاج بھوپالی 	/poets/taj-bhopali?lang=ur
تاج سعید 	/poets/taj-saeed?lang=ur
تجمل حسین اختر 	/poets/tajammul-hussain-akhtar?lang=ur
تاجدار عادل 	/poets/tajdar-adil?lang=ur
تاجور نجیب آبادی 	/poets/tajvar-najibabadi?lang=ur
تخت سنگھ 	/poets/takht-singh?lang=ur
طلعت اشارت 	/poets/talat-isharat?lang=ur
تالیف حیدر 	/poets/taleef-haidar?lang=ur
طلحہ رضوی برق 	/poets/talha-rizvi-barq?lang=ur
طالب علی خان عیشی 	/poets/talib-ali-khaan-aishi?lang=ur
طالب انصاری 	/poets/talib-ansari?lang=ur
طالب باغپتی 	/poets/talib-baghpati?lang=ur
طالب چکوالی 	/poets/talib-chakwali?lang=ur
طالب حسین طالب 	/poets/talib-husain-talib?lang=ur
طالب جوہری 	/poets/talib-johari?lang=ur
تمنا جمالی 	/poets/tamanna-jamali?lang=ur
تمیزالدین تمیز دہلوی 	/poets/tameezuddin-tameez-dehlvi?lang=ur
تنہا تماپوری 	/poets/tanha-timmapuri?lang=ur
تنویر احمد علوی 	/poets/tanveer-ahmad-alvi?lang=ur
تنویر انجم 	/poets/tanveer-anjum?lang=ur
تنویر مونس 	/poets/tanveer-monis?lang=ur
تنویر نقوی 	/poets/tanveer-naqvi?lang=ur
تنویر سامانی 	/poets/tanveer-samani?lang=ur
تنویر سپرا 	/poets/tanveer-sipra?lang=ur
تنویر دہلوی 	/poets/tanvir-dehlvi?lang=ur
تنویر گوہر 	/poets/tanweer-gauhar?lang=ur
طاؤس 	/poets/taoos?lang=ur
ترنم ریاض 	/poets/tarannum-riyaz?lang=ur
طارق بدایونی 	/poets/tariq-badayuni?lang=ur
تعشق لکھنوی 	/poets/taashshuq-lakhnavi?lang=ur
تاب اسلم 	/poets/tab-aslam?lang=ur
تاباں عبد الحی 	/poets/taban-abdul-hai?lang=ur
غلام ربانی تاباںؔ 	/poets/taban-ghulam-rabbani?lang=ur
تبسم کاشمیری 	/poets/tabassum-kashmiri?lang=ur
تبسم رضوی 	/poets/tabassum-rizvi?lang=ur
تابش دہلوی 	/poets/tabish-dehlvi?lang=ur
تابش کمال 	/poets/tabish-kamal?lang=ur
تابش کانپوری 	/poets/tabish-kanpuri?lang=ur
تابش مہدی 	/poets/tabish-mehdi?lang=ur
تابش صدیقی 	/poets/tabish-siddiqui?lang=ur
تفضل حسین خاں کوکب دہلوی 	/poets/tafazzul-husain-khan-kaukab-dehlavi?lang=ur
تفضیل احمد 	/poets/tafzeel-ahmad?lang=ur
طاہر عدیم 	/poets/tahir-adeem?lang=ur
طاہر عظیم 	/poets/tahir-azeem?lang=ur
طاہر فراز 	/poets/tahir-faraz?lang=ur
طاہر تونسوی 	/poets/tahir-tonsvi?lang=ur
طاہرہ جبین تارا 	/poets/tahira-jabeen-tara?lang=ur
تحسین فراقی 	/poets/tahseen-firaqi?lang=ur
تہذیب حافی 	/poets/tahzeeb-hafi?lang=ur
تیمور حسن 	/poets/taimur-hasan?lang=ur
تاج بھوپالی 	/poets/taj-bhopali?lang=ur
تاج سعید 	/poets/taj-saeed?lang=ur
تجمل حسین اختر 	/poets/tajammul-hussain-akhtar?lang=ur
تاجدار عادل 	/poets/tajdar-adil?lang=ur
تاجور نجیب آبادی 	/poets/tajvar-najibabadi?lang=ur
تخت سنگھ 	/poets/takht-singh?lang=ur
طلعت اشارت 	/poets/talat-isharat?lang=ur
تالیف حیدر 	/poets/taleef-haidar?lang=ur
طلحہ رضوی برق 	/poets/talha-rizvi-barq?lang=ur
طالب علی خان عیشی 	/poets/talib-ali-khaan-aishi?lang=ur
طالب انصاری 	/poets/talib-ansari?lang=ur
طالب باغپتی 	/poets/talib-baghpati?lang=ur
طالب چکوالی 	/poets/talib-chakwali?lang=ur
طالب حسین طالب 	/poets/talib-husain-talib?lang=ur
طالب جوہری 	/poets/talib-johari?lang=ur
تمنا جمالی 	/poets/tamanna-jamali?lang=ur
تمیزالدین تمیز دہلوی 	/poets/tameezuddin-tameez-dehlvi?lang=ur
تنہا تماپوری 	/poets/tanha-timmapuri?lang=ur
تنویر احمد علوی 	/poets/tanveer-ahmad-alvi?lang=ur
تنویر انجم 	/poets/tanveer-anjum?lang=ur
تنویر مونس 	/poets/tanveer-monis?lang=ur
تنویر نقوی 	/poets/tanveer-naqvi?lang=ur
تنویر سامانی 	/poets/tanveer-samani?lang=ur
تنویر سپرا 	/poets/tanveer-sipra?lang=ur
تنویر دہلوی 	/poets/tanvir-dehlvi?lang=ur
تنویر گوہر 	/poets/tanweer-gauhar?lang=ur
طاؤس 	/poets/taoos?lang=ur
ترنم ریاض 	/poets/tarannum-riyaz?lang=ur
طارق بدایونی 	/poets/tariq-badayuni?lang=ur
طارق بٹ 	/poets/tariq-butt?lang=ur
طارق ہاشمی 	/poets/tariq-hashmi?lang=ur
طارق جامی 	/poets/tariq-jami?lang=ur
طارق مسعود 	/poets/tariq-masood?lang=ur
طارق متین 	/poets/tariq-matin?lang=ur
طارق نعیم 	/poets/tariq-naeem?lang=ur
طارق پیرزادہ 	/poets/tariq-pirzada?lang=ur
طارق قمر 	/poets/tariq-qamar?lang=ur
طارق رشید درویش 	/poets/tariq-rashid-darvesh?lang=ur
طارق شاہد 	/poets/tariq-shahid?lang=ur
ترکش پردیپ 	/poets/tarkash-pradeep?lang=ur
ترونا مشرا 	/poets/taruna-mishra?lang=ur
تصدق حسین خالد 	/poets/tasadduq-husain-khalid?lang=ur
تصور زیدی 	/poets/tasawwur-zaidi?lang=ur
تاثیر صدیقی 	/poets/taseer-siddiqui?lang=ur
تاشی ظہیر 	/poets/tashi-zaheer?lang=ur
میر تسکینؔ دہلوی 	/poets/taskeen-dehlavi?lang=ur
تسلیم احمد تصور 	/poets/tasleem-ahmad-tasavvur?lang=ur
تسلیم الہی زلفی 	/poets/tasleem-ilahi-zulfi?lang=ur
تسنیم عابدی 	/poets/tasneem-abidi?lang=ur
تسنیم فاروقی 	/poets/tasneem-faruqi?lang=ur
توفیق ساگر 	/poets/taufeeq-sagar?lang=ur
توقیر عباس 	/poets/tauqeer-abbas?lang=ur
توقیر احمد 	/poets/tauqeer-ahmad?lang=ur
توقیر رضا 	/poets/tauqeer-raza?lang=ur
توقیر تقی 	/poets/tauqeer-taqi?lang=ur
توصیف تبسم 	/poets/tauseef-tabassum?lang=ur
طفل دارا 	/poets/tifl-dara?lang=ur
تلک راج پارس 	/poets/tilak-raj-paras?lang=ur
تلوک چند محروم 	/poets/tilok-chand-mahroom?lang=ur
تشنہ بریلوی 	/poets/tishna-barelvi?lang=ur
توصیف تابش 	/poets/tousief-tabish?lang=ur
تری پراری 	/poets/tripurari?lang=ur
طفیل احمد مدنی 	/poets/tufail-ahmad-madni?lang=ur
طفیل بسمل 	/poets/tufail-bismil?lang=ur
طفیل چترویدی 	/poets/tufail-chaturvedi?lang=ur
طفیل دارا 	/poets/tufail-dara?lang=ur
طرفہ قریشی 	/poets/turfa-qureshi?lang=ur
افق لکھنوی 	/poets/ufuq-lakhnavi?lang=ur
اوما شنکر چترونشی بازل 	/poets/uma-shankar-chitravanshi-bazal?lang=ur
عمیر منظر 	/poets/umair-manzar?lang=ur
عمیر نجمی 	/poets/umair-najmi?lang=ur
امنگ بالی 	/poets/umang-bali?lang=ur
عمر انصاری 	/poets/umar-ansari?lang=ur
عمر فرحت 	/poets/umar-farhat?lang=ur
عمر فاروق 	/poets/umar-farooq?lang=ur
امید فاضلی 	/poets/ummeed-fazli?lang=ur
امید خواجہ 	/poets/ummeed-khwaja?lang=ur
عنوان چشتی 	/poets/unwan-chishti?lang=ur
عرفی آفاقی 	/poets/urfi-aafaqi?lang=ur
ارملا مادھو 	/poets/urmila-madhav?lang=ur
عروج جعفری 	/poets/urooj-jafri?lang=ur
عروج قادری 	/poets/urooj-qadri?lang=ur
عروج زیدی بدایونی 	/poets/urooj-zaidi-badayuni?lang=ur
عروج زہرا زیدی 	/poets/urooj-zehra-zaidi?lang=ur
اوشا بھدوریہ 	/poets/usha-bhadoriya?lang=ur
افق لکھنوی 	/poets/ufuq-lakhnavi?lang=ur
اوما شنکر چترونشی بازل 	/poets/uma-shankar-chitravanshi-bazal?lang=ur
عمیر منظر 	/poets/umair-manzar?lang=ur
عمیر نجمی 	/poets/umair-najmi?lang=ur
امنگ بالی 	/poets/umang-bali?lang=ur
عمر انصاری 	/poets/umar-ansari?lang=ur
عمر فرحت 	/poets/umar-farhat?lang=ur
عمر فاروق 	/poets/umar-farooq?lang=ur
امید فاضلی 	/poets/ummeed-fazli?lang=ur
امید خواجہ 	/poets/ummeed-khwaja?lang=ur
عنوان چشتی 	/poets/unwan-chishti?lang=ur
عرفی آفاقی 	/poets/urfi-aafaqi?lang=ur
ارملا مادھو 	/poets/urmila-madhav?lang=ur
عروج جعفری 	/poets/urooj-jafri?lang=ur
عروج قادری 	/poets/urooj-qadri?lang=ur
عروج زیدی بدایونی 	/poets/urooj-zaidi-badayuni?lang=ur
عروج زہرا زیدی 	/poets/urooj-zehra-zaidi?lang=ur
اوشا بھدوریہ 	/poets/usha-bhadoriya?lang=ur
وفا براہی 	/poets/vafa-barahi?lang=ur
وفا ملک پوری 	/poets/vafa-malikpuri?lang=ur
وحشی کانپوری 	/poets/vahshi-kanpuri?lang=ur
ولی مدنی 	/poets/vali-madni?lang=ur
وارث کرمانی 	/poets/varis-kirmani?lang=ur
ورشا گورچھیہ 	/poets/varsha-gorchhia?lang=ur
ورون آنند 	/poets/varun-anand?lang=ur
وصاف باسط 	/poets/vasaf-basit?lang=ur
وجے ارون 	/poets/vijay-arun?lang=ur
وجے شرما عرش 	/poets/vijay-sharma-arsh?lang=ur
وکاس رانا 	/poets/vikas-rana?lang=ur
وکاس شرما راز 	/poets/vikas-sharma-raaz?lang=ur
ولاس پنڈت مسافر 	/poets/vilas-pandit-musafir?lang=ur
ونیت آشنا 	/poets/vineet-aashna?lang=ur
ونود کمار ترپاٹھی بشر  new	/poets/vinod-kumar-tripathi-bashar?lang=ur
وپل کمار 	/poets/vipul-kumar?lang=ur
وشال کھلر 	/poets/vishal-khullar?lang=ur
وشمہ خان وشمہ 	/poets/vishma-khan-vishma?lang=ur
وشو ناتھ درد 	/poets/vishvanath-dard?lang=ur
وفا براہی 	/poets/vafa-barahi?lang=ur
وفا ملک پوری 	/poets/vafa-malikpuri?lang=ur
وحشی کانپوری 	/poets/vahshi-kanpuri?lang=ur
ولی مدنی 	/poets/vali-madni?lang=ur
وارث کرمانی 	/poets/varis-kirmani?lang=ur
ورشا گورچھیہ 	/poets/varsha-gorchhia?lang=ur
ورون آنند 	/poets/varun-anand?lang=ur
وصاف باسط 	/poets/vasaf-basit?lang=ur
وجے ارون 	/poets/vijay-arun?lang=ur
وجے شرما عرش 	/poets/vijay-sharma-arsh?lang=ur
وکاس رانا 	/poets/vikas-rana?lang=ur
وکاس شرما راز 	/poets/vikas-sharma-raaz?lang=ur
ولاس پنڈت مسافر 	/poets/vilas-pandit-musafir?lang=ur
ونیت آشنا 	/poets/vineet-aashna?lang=ur
ونود کمار ترپاٹھی بشر  new	/poets/vinod-kumar-tripathi-bashar?lang=ur
وپل کمار 	/poets/vipul-kumar?lang=ur
وشال کھلر 	/poets/vishal-khullar?lang=ur
وشمہ خان وشمہ 	/poets/vishma-khan-vishma?lang=ur
وشو ناتھ درد 	/poets/vishvanath-dard?lang=ur
وفا نقوی 	/poets/wafa-naqvi?lang=ur
وفا صدیقی 	/poets/wafa-siddiqui?lang=ur
وہاب دانش 	/poets/wahab-danish?lang=ur
وحید احمد  	/poets/waheed-ahmad?lang=ur
وحید اختر 	/poets/waheed-akhtar?lang=ur
وحید الہ آبادی 	/poets/waheed-allahabadi?lang=ur
وحید قریشی 	/poets/waheed-quraishi?lang=ur
وحیدہ نسیم 	/poets/waheeda-naseem?lang=ur
وحید الحسن ہاشمی 	/poets/waheed-ul-hasan-hashmi?lang=ur
واحد پریمی 	/poets/wahid-premi?lang=ur
وحید الدین سلیم 	/poets/wahiduddin-saleem?lang=ur
وحشتؔ رضا علی کلکتوی 	/poets/wahshat-raza-ali-kalkatvi?lang=ur
واعظہ رفیق 	/poets/waiza-rafeeq?lang=ur
وجد چغتائی 	/poets/wajd-chughtai?lang=ur
وجیہ ثانی 	/poets/wajeeh-sani?lang=ur
واجد علی شاہ اختر 	/poets/wajid-ali-shah-akhtar?lang=ur
واجد امیر 	/poets/wajid-ameer?lang=ur
واجد قریشی 	/poets/wajid-qureshi?lang=ur
واجد سحری 	/poets/wajid-sahri?lang=ur
وکیل اختر 	/poets/wakil-akhtar?lang=ur
والی آسی 	/poets/wali-aasi?lang=ur
ولی عالم شاہین 	/poets/wali-alam-shaheen?lang=ur
ولی محمد ولی 	/poets/wali-mohammad-wali?lang=ur
ولی شمسی 	/poets/wali-shamsi?lang=ur
ولی عزلت 	/poets/wali-uzlat?lang=ur
ولی اللہ محب 	/poets/waliullah-muhib?lang=ur
ولی اللہ سرہندی اشتیاق 	/poets/waliullah-sarhindi-ishtiyaq?lang=ur
ولی اللہ ولی 	/poets/waliullah-wali?lang=ur
وامق جونپوری 	/poets/wamiq-jaunpuri?lang=ur
وقار بجنوری 	/poets/waqar-bijnori?lang=ur
وقار فاطمی 	/poets/waqar-fatmi?lang=ur
وقار حلم سید نگلوی 	/poets/waqar-hilm-syed-naglavi?lang=ur
وقار خان 	/poets/waqar-khan?lang=ur
وقار مانوی 	/poets/waqar-manvi?lang=ur
وقار سحر 	/poets/waqar-sahar?lang=ur
وقار واثقی 	/poets/waqar-vasiqi?lang=ur
وقاص عزیز 	/poets/waqas-aziz?lang=ur
وقاص بلوچ 	/poets/waqas-baloch?lang=ur
واقف رائے بریلوی 	/poets/waqif-rae-barelvi?lang=ur
وسیم اکرم 	/poets/waseem-akram?lang=ur
وسیم بریلوی 	/poets/waseem-barelvi?lang=ur
وسیم خیر آبادی 	/poets/waseem-khairabadi?lang=ur
وسیم ملک 	/poets/waseem-malik?lang=ur
وسیم مینائی 	/poets/waseem-minai?lang=ur
وسیم تاشف 	/poets/waseem-tashif?lang=ur
وصی شاہ 	/poets/wasi-shah?lang=ur
واصف دہلوی 	/poets/wasif-dehlvi?lang=ur
واصف یار 	/poets/wasif-yar?lang=ur
وزیر آغا 	/poets/wazir-agha?lang=ur
وزیر علی صبا لکھنؤی 	/poets/wazir-ali-saba-lakhnavi?lang=ur
وفا نقوی 	/poets/wafa-naqvi?lang=ur
وفا صدیقی 	/poets/wafa-siddiqui?lang=ur
وہاب دانش 	/poets/wahab-danish?lang=ur
وحید احمد  	/poets/waheed-ahmad?lang=ur
وحید اختر 	/poets/waheed-akhtar?lang=ur
وحید الہ آبادی 	/poets/waheed-allahabadi?lang=ur
وحید قریشی 	/poets/waheed-quraishi?lang=ur
وحیدہ نسیم 	/poets/waheeda-naseem?lang=ur
وحید الحسن ہاشمی 	/poets/waheed-ul-hasan-hashmi?lang=ur
واحد پریمی 	/poets/wahid-premi?lang=ur
وحید الدین سلیم 	/poets/wahiduddin-saleem?lang=ur
وحشتؔ رضا علی کلکتوی 	/poets/wahshat-raza-ali-kalkatvi?lang=ur
واعظہ رفیق 	/poets/waiza-rafeeq?lang=ur
وجد چغتائی 	/poets/wajd-chughtai?lang=ur
وجیہ ثانی 	/poets/wajeeh-sani?lang=ur
واجد علی شاہ اختر 	/poets/wajid-ali-shah-akhtar?lang=ur
واجد امیر 	/poets/wajid-ameer?lang=ur
واجد قریشی 	/poets/wajid-qureshi?lang=ur
واجد سحری 	/poets/wajid-sahri?lang=ur
وکیل اختر 	/poets/wakil-akhtar?lang=ur
والی آسی 	/poets/wali-aasi?lang=ur
ولی عالم شاہین 	/poets/wali-alam-shaheen?lang=ur
ولی محمد ولی 	/poets/wali-mohammad-wali?lang=ur
ولی شمسی 	/poets/wali-shamsi?lang=ur
ولی عزلت 	/poets/wali-uzlat?lang=ur
ولی اللہ محب 	/poets/waliullah-muhib?lang=ur
ولی اللہ سرہندی اشتیاق 	/poets/waliullah-sarhindi-ishtiyaq?lang=ur
ولی اللہ ولی 	/poets/waliullah-wali?lang=ur
وامق جونپوری 	/poets/wamiq-jaunpuri?lang=ur
وقار بجنوری 	/poets/waqar-bijnori?lang=ur
وقار فاطمی 	/poets/waqar-fatmi?lang=ur
وقار حلم سید نگلوی 	/poets/waqar-hilm-syed-naglavi?lang=ur
وقار خان 	/poets/waqar-khan?lang=ur
وقار مانوی 	/poets/waqar-manvi?lang=ur
وقار سحر 	/poets/waqar-sahar?lang=ur
وقار واثقی 	/poets/waqar-vasiqi?lang=ur
وقاص عزیز 	/poets/waqas-aziz?lang=ur
وقاص بلوچ 	/poets/waqas-baloch?lang=ur
واقف رائے بریلوی 	/poets/waqif-rae-barelvi?lang=ur
وسیم اکرم 	/poets/waseem-akram?lang=ur
وسیم بریلوی 	/poets/waseem-barelvi?lang=ur
وسیم خیر آبادی 	/poets/waseem-khairabadi?lang=ur
وسیم ملک 	/poets/waseem-malik?lang=ur
وسیم مینائی 	/poets/waseem-minai?lang=ur
وسیم تاشف 	/poets/waseem-tashif?lang=ur
وصی شاہ 	/poets/wasi-shah?lang=ur
واصف دہلوی 	/poets/wasif-dehlvi?lang=ur
واصف یار 	/poets/wasif-yar?lang=ur
وزیر آغا 	/poets/wazir-agha?lang=ur
وزیر علی صبا لکھنؤی 	/poets/wazir-ali-saba-lakhnavi?lang=ur
یگانہ چنگیزی 	/poets/yagana-changezi?lang=ur
یحی امجد 	/poets/yahya-amjad?lang=ur
یحیٰ خالد 	/poets/yahya-khalid?lang=ur
یحیٰ خان یوسف زئی 	/poets/yahya-khan-yusuf-zai?lang=ur
 یامین 	/poets/yameen?lang=ur
انعام اللہ خاں یقینؔ 	/poets/yaqeen-inamullah-khan?lang=ur
یعقوب عامر 	/poets/yaqoob-aamir?lang=ur
یعقوب علی آسی 	/poets/yaqoob-ali-aasi?lang=ur
یعقوب عارف 	/poets/yaqoob-arif?lang=ur
یعقوب راہی 	/poets/yaqoob-rahi?lang=ur
یعقوب تصور 	/poets/yaqoob-tasawwur?lang=ur
یعقوب عثمانی 	/poets/yaqoob-usmani?lang=ur
یعقوب یاور 	/poets/yaqoob-yawar?lang=ur
یٰسین آفاقی 	/poets/yaseen-afaqi?lang=ur
یٰسین افضال 	/poets/yaseen-afzal?lang=ur
یٰسین قدرت 	/poets/yaseen-qudrat?lang=ur
یاسین ضمیر 	/poets/yaseen-zameer?lang=ur
یشب تمنا 	/poets/yashab-tamanna?lang=ur
یشپال گپتا 	/poets/yashpal-gupta?lang=ur
یاسین علی خاں مرکز 	/poets/yasin-ali-khan-markaz?lang=ur
یاسمین حبیب 	/poets/yasmeen-habeeb?lang=ur
یاسمین حمید 	/poets/yasmeen-hameed?lang=ur
یاور عباس 	/poets/yawar-abbas?lang=ur
یاور امان 	/poets/yawar-amaan?lang=ur
یزدانی جالندھری 	/poets/yazdani-jalandhari?lang=ur
یوگیندر بہل تشنہ 	/poets/yogendra-bahal-tishna?lang=ur
یونس غازی 	/poets/yunus-ghazi?lang=ur
یوسف اعظمی 	/poets/yusuf-azmi?lang=ur
یوسف حسن 	/poets/yusuf-hasan?lang=ur
یوسف جمال 	/poets/yusuf-jamal?lang=ur
یوسف کامران 	/poets/yusuf-kamran?lang=ur
یوسف خالد 	/poets/yusuf-khalid?lang=ur
یوسف راحت 	/poets/yusuf-rahat?lang=ur
یوسف تقی 	/poets/yusuf-taqi?lang=ur
یوسف ظفر 	/poets/yusuf-zafar?lang=ur
یگانہ چنگیزی 	/poets/yagana-changezi?lang=ur
یحی امجد 	/poets/yahya-amjad?lang=ur
یحیٰ خالد 	/poets/yahya-khalid?lang=ur
یحیٰ خان یوسف زئی 	/poets/yahya-khan-yusuf-zai?lang=ur
 یامین 	/poets/yameen?lang=ur
انعام اللہ خاں یقینؔ 	/poets/yaqeen-inamullah-khan?lang=ur
یعقوب عامر 	/poets/yaqoob-aamir?lang=ur
یعقوب علی آسی 	/poets/yaqoob-ali-aasi?lang=ur
یعقوب عارف 	/poets/yaqoob-arif?lang=ur
یعقوب راہی 	/poets/yaqoob-rahi?lang=ur
یعقوب تصور 	/poets/yaqoob-tasawwur?lang=ur
یعقوب عثمانی 	/poets/yaqoob-usmani?lang=ur
یعقوب یاور 	/poets/yaqoob-yawar?lang=ur
یٰسین آفاقی 	/poets/yaseen-afaqi?lang=ur
یٰسین افضال 	/poets/yaseen-afzal?lang=ur
یٰسین قدرت 	/poets/yaseen-qudrat?lang=ur
یاسین ضمیر 	/poets/yaseen-zameer?lang=ur
یشب تمنا 	/poets/yashab-tamanna?lang=ur
یشپال گپتا 	/poets/yashpal-gupta?lang=ur
یاسین علی خاں مرکز 	/poets/yasin-ali-khan-markaz?lang=ur
یاسمین حبیب 	/poets/yasmeen-habeeb?lang=ur
یاسمین حمید 	/poets/yasmeen-hameed?lang=ur
یاور عباس 	/poets/yawar-abbas?lang=ur
یاور امان 	/poets/yawar-amaan?lang=ur
یزدانی جالندھری 	/poets/yazdani-jalandhari?lang=ur
یوگیندر بہل تشنہ 	/poets/yogendra-bahal-tishna?lang=ur
یونس غازی 	/poets/yunus-ghazi?lang=ur
یوسف اعظمی 	/poets/yusuf-azmi?lang=ur
یوسف حسن 	/poets/yusuf-hasan?lang=ur
یوسف جمال 	/poets/yusuf-jamal?lang=ur
یوسف کامران 	/poets/yusuf-kamran?lang=ur
یوسف خالد 	/poets/yusuf-khalid?lang=ur
یوسف راحت 	/poets/yusuf-rahat?lang=ur
یوسف تقی 	/poets/yusuf-taqi?lang=ur
یوسف ظفر 	/poets/yusuf-zafar?lang=ur
زعیم رشید 	/poets/zaeem-rasheed?lang=ur
ظفر احمد پرواز 	/poets/zafar-ahmad-parwaz?lang=ur
ظفر عجمی 	/poets/zafar-ajmi?lang=ur
ظفر اکبرآبادی 	/poets/zafar-akbarabadi?lang=ur
ظفر علی خاں 	/poets/zafar-ali-khan?lang=ur
ظفر انصاری ظفر 	/poets/zafar-ansari-zafar?lang=ur
ظفر انور 	/poets/zafar-anwar?lang=ur
ظفر غوری 	/poets/zafar-ghauri?lang=ur
ظفر گورکھپوری 	/poets/zafar-gorakhpuri?lang=ur
ظفر حمیدی 	/poets/zafar-hameedi?lang=ur
ظفر امام 	/poets/zafar-imam?lang=ur
ظفر اقبال 	/poets/zafar-iqbal?lang=ur
ظفر اقبال ظفر 	/poets/zafar-iqbal-zafar?lang=ur
ظفر کلیم 	/poets/zafar-kaleem?lang=ur
ظفر کمالی 	/poets/zafar-kamali?lang=ur
ظفر خان نیازی 	/poets/zafar-khan-niyazi?lang=ur
ظفر مرادآبادی 	/poets/zafar-moradabadi?lang=ur
ظفر رباب 	/poets/zafar-rabab?lang=ur
ظفر صہبائی 	/poets/zafar-sahbai?lang=ur
ظفر صدیقی 	/poets/zafar-siddiqui?lang=ur
ظفر تاباں 	/poets/zafar-taban?lang=ur
ظفر تابش 	/poets/zafar-tabish?lang=ur
ظفر زیدی 	/poets/zafar-zaidi?lang=ur
ظفر الحسنین ظفر 	/poets/zafarul-hasnain-zafar?lang=ur
ظہیر احمد ظہیر 	/poets/zaheer-ahmad-zaheer?lang=ur
ظہیرؔ دہلوی 	/poets/zaheer-dehlvi?lang=ur
ظہیر فتح پوری 	/poets/zaheer-fatehpuri?lang=ur
ظہیرؔ غازی پوری 	/poets/zaheer-ghazipuri?lang=ur
ظہیر کاشمیری 	/poets/zaheer-kashmiri?lang=ur
ظہیرؔ رحمتی 	/poets/zaheer-rahmati?lang=ur
ظہیر صدیقی 	/poets/zaheer-siddiqui?lang=ur
زاہد آفاق 	/poets/zahid-afaq?lang=ur
زاہد چوہدری 	/poets/zahid-chaudhry?lang=ur
زاہد ڈار 	/poets/zahid-dar?lang=ur
زاہد فخری 	/poets/zahid-fakhri?lang=ur
زاہد فارانی 	/poets/zahid-farani?lang=ur
زاہد حسن 	/poets/zahid-hasan?lang=ur
زاہد حسن چغتائی 	/poets/zahid-hasan-chugtai?lang=ur
زاہد امروز 	/poets/zahid-imroz?lang=ur
زاہد کمال 	/poets/zahid-kamal?lang=ur
زاہد مسعود 	/poets/zahid-masood?lang=ur
زاہد منیر عامر 	/poets/zahid-muneer-amir?lang=ur
زاہد نوید 	/poets/zahid-naved?lang=ur
زاہد شمسی 	/poets/zahid-shamsi?lang=ur
زاہدہ حنا 	/poets/zahida-hina-3?lang=ur
زاہدہ کمال 	/poets/zahida-kamal?lang=ur
زاہدہ زیدی 	/poets/zahida-zaidi?lang=ur
زاہد الحق 	/poets/zahidul-haque?lang=ur
ظہیر احمد تاج 	/poets/zahiir-ahmad-taaj?lang=ur
زہرا قرار 	/poets/zahraa-qarar?lang=ur
زعیم رشید 	/poets/zaeem-rasheed?lang=ur
ظفر احمد پرواز 	/poets/zafar-ahmad-parwaz?lang=ur
ظفر عجمی 	/poets/zafar-ajmi?lang=ur
ظفر اکبرآبادی 	/poets/zafar-akbarabadi?lang=ur
ظفر علی خاں 	/poets/zafar-ali-khan?lang=ur
ظفر انصاری ظفر 	/poets/zafar-ansari-zafar?lang=ur
ظفر انور 	/poets/zafar-anwar?lang=ur
ظفر غوری 	/poets/zafar-ghauri?lang=ur
ظفر گورکھپوری 	/poets/zafar-gorakhpuri?lang=ur
ظفر حمیدی 	/poets/zafar-hameedi?lang=ur
ظفر امام 	/poets/zafar-imam?lang=ur
ظفر اقبال 	/poets/zafar-iqbal?lang=ur
ظفر اقبال ظفر 	/poets/zafar-iqbal-zafar?lang=ur
ظفر کلیم 	/poets/zafar-kaleem?lang=ur
ظفر کمالی 	/poets/zafar-kamali?lang=ur
ظفر خان نیازی 	/poets/zafar-khan-niyazi?lang=ur
ظفر مرادآبادی 	/poets/zafar-moradabadi?lang=ur
ظفر رباب 	/poets/zafar-rabab?lang=ur
ظفر صہبائی 	/poets/zafar-sahbai?lang=ur
ظفر صدیقی 	/poets/zafar-siddiqui?lang=ur
ظفر تاباں 	/poets/zafar-taban?lang=ur
ظفر تابش 	/poets/zafar-tabish?lang=ur
ظفر زیدی 	/poets/zafar-zaidi?lang=ur
ظفر الحسنین ظفر 	/poets/zafarul-hasnain-zafar?lang=ur
ظہیر احمد ظہیر 	/poets/zaheer-ahmad-zaheer?lang=ur
ظہیرؔ دہلوی 	/poets/zaheer-dehlvi?lang=ur
ظہیر فتح پوری 	/poets/zaheer-fatehpuri?lang=ur
ظہیرؔ غازی پوری 	/poets/zaheer-ghazipuri?lang=ur
ظہیر کاشمیری 	/poets/zaheer-kashmiri?lang=ur
ظہیرؔ رحمتی 	/poets/zaheer-rahmati?lang=ur
ظہیر صدیقی 	/poets/zaheer-siddiqui?lang=ur
زاہد آفاق 	/poets/zahid-afaq?lang=ur
زاہد چوہدری 	/poets/zahid-chaudhry?lang=ur
زاہد ڈار 	/poets/zahid-dar?lang=ur
زاہد فخری 	/poets/zahid-fakhri?lang=ur
زاہد فارانی 	/poets/zahid-farani?lang=ur
زاہد حسن 	/poets/zahid-hasan?lang=ur
زاہد حسن چغتائی 	/poets/zahid-hasan-chugtai?lang=ur
زاہد امروز 	/poets/zahid-imroz?lang=ur
زاہد کمال 	/poets/zahid-kamal?lang=ur
زاہد مسعود 	/poets/zahid-masood?lang=ur
زاہد منیر عامر 	/poets/zahid-muneer-amir?lang=ur
زاہد نوید 	/poets/zahid-naved?lang=ur
زاہد شمسی 	/poets/zahid-shamsi?lang=ur
زاہدہ حنا 	/poets/zahida-hina-3?lang=ur
زاہدہ کمال 	/poets/zahida-kamal?lang=ur
زاہدہ زیدی 	/poets/zahida-zaidi?lang=ur
زاہد الحق 	/poets/zahidul-haque?lang=ur
ظہیر احمد تاج 	/poets/zahiir-ahmad-taaj?lang=ur
زہرا قرار 	/poets/zahraa-qarar?lang=ur
ظہور اللہ بدایونی نوا 	/poets/zahurullah-badayuni-nava?lang=ur
زیب عثمانیہ  	/poets/zaib-usmania?lang=ur
زید امبساط 	/poets/zaid-imbisat?lang=ur
ضیغم حمیدی 	/poets/zaigham-hameedi?lang=ur
زین رامش 	/poets/zain-ramish?lang=ur
زینب بیگم عبرت 	/poets/zainab-begum-ibrat?lang=ur
زین العابدین خاں عارف 	/poets/zain-ul-abideen-khan-arif?lang=ur
ذکا صدیقی 	/poets/zaka-siddiqui?lang=ur
زکریا شاذ 	/poets/zakariya-shaz?lang=ur
ذکاء الدین شایاں 	/poets/zakauddin-shayan?lang=ur
زخمی حصاری 	/poets/zakhmi-hisari?lang=ur
ذکی کاکوروی 	/poets/zaki-kakorvi?lang=ur
ذکی طارق 	/poets/zaki-tariq?lang=ur
ذکیہ غزل 	/poets/zakia-ghazal?lang=ur
ذاکر خان ذاکر 	/poets/zakir-khan-zakir?lang=ur
زمان کنجاہی 	/poets/zaman-kanjahi?lang=ur
زمان ملک 	/poets/zaman-malik?lang=ur
ضمیر اترولوی 	/poets/zameer-atraulvi?lang=ur
ضمیر اظہر 	/poets/zameer-azhar?lang=ur
ضمیر کاظمی 	/poets/zameer-kazmi?lang=ur
ظریف لکھنوی 	/poets/zareef-lakhnavi?lang=ur
زرینہ ثانی 	/poets/zareena-sani?lang=ur
ذوقی مظفر نگری 	/poets/zauqi-muzaffar-nagari?lang=ur
ز خ ش  	/poets/ze-khe-sheen?lang=ur
زیب بریلوی 	/poets/zeb-bareilwi?lang=ur
زیب غوری 	/poets/zeb-ghauri?lang=ur
زیبا 	/poets/zeba?lang=ur
زیب النسا زیبی 	/poets/zebunnisaa-zaibii?lang=ur
زیف ضیاء 	/poets/zeef-zia?lang=ur
ذیشان ساجد 	/poets/zeeshaan-sajid?lang=ur
ذیشان اطہر 	/poets/zeeshan-athar?lang=ur
ذیشان حیدر 	/poets/zeeshan-haider?lang=ur
ذیشان الٰہی 	/poets/zeeshan-ilahi?lang=ur
ذیشان مہدی 	/poets/zeeshan-mehdi?lang=ur
ذیشان ساحل 	/poets/zeeshan-sahil-1?lang=ur
زہرا علوی 	/poets/zehra-alvi?lang=ur
زہرا نگاہ 	/poets/zehra-nigaah?lang=ur
ضیا فاروقی 	/poets/zia-faruqi?lang=ur
ضیا فتح آبادی 	/poets/zia-fatehabadi?lang=ur
ضیا جالندھری 	/poets/zia-jalandhari?lang=ur
ضیا ضمیر 	/poets/zia-zameer?lang=ur
ضیا الدین احمد شکیب 	/poets/ziauddin-ahmad-shakeb?lang=ur
ضیاء الحق قاسمی 	/poets/zia-ul-haq-qasmi?lang=ur
ضیاء المصطفیٰ ترکؔ 	/poets/zia-ul-mustafa-turk?lang=ur
ضیاء الرحمن اعظمی 	/poets/ziaur-rahman-azmi?lang=ur
ضیاء مذکور 	/poets/ziya-mazkoor?lang=ur
ضیا شبنمی 	/poets/ziya-shabnami?lang=ur
ضیاء الحسن 	/poets/ziyaul-hasan?lang=ur
زہرہ نسیم 	/poets/zohra-naseem?lang=ur
زبیر علی تابش 	/poets/zubair-ali-tabish?lang=ur
زبیر امروہوی 	/poets/zubair-amrohvi?lang=ur
زبیر فاروقؔ 	/poets/zubair-farooq?lang=ur
زبیر قیصر 	/poets/zubair-qaisar?lang=ur
زبیر رضوی 	/poets/zubair-rizvi?lang=ur
زبیر شفائی 	/poets/zubair-shifai?lang=ur
زہیر کنجاہی 	/poets/zuhair-kanjahi?lang=ur
ظہور نظر 	/poets/zuhoor-nazar?lang=ur
ظہور الاسلام جاوید 	/poets/zuhoor-ul-islam-javed?lang=ur
ذوالفقار احمد 	/poets/zulfeqar-ahmad?lang=ur
ذوالفقار عادل 	/poets/zulfiqar-aadil?lang=ur
ذالفقار احمد تابش 	/poets/zulfiqar-ahmad-tabish?lang=ur
ذوالفقار احسن 	/poets/zulfiqar-ahsan?lang=ur
ذوالفقار علی بخاری 	/poets/zulfiqar-ali-bukhari?lang=ur
ذوالفقار نقوی 	/poets/zulfiqar-naqvi?lang=ur
