A G Josh 	/poets/a-g-josh
Aabida Urooj 	/poets/aabida-urooj
Aadil Raza Mansoori 	/poets/aadil-raza-mansoori
Aafaque Siddiqui 	/poets/aafaque-siddiqui
aaftaab-ud-Daula Lakhnavi Qalaq 	/poets/aaftaab-ud-daula-lakhnavi-qalaq
Aaftab Rais Panipati 	/poets/aaftab-rais-panipati
Aaga nisaar 	/poets/aaga-nisaar
Aagha Akbarabadi 	/poets/aagha-akbarabadi
Aal-e-Ahmad Suroor 	/poets/aal-e-ahmad-suroor
Aal-e-Raza Raza 	/poets/aal-e-raza-raza
Aalok Shrivastav 	/poets/aalok-shrivastav
Aamir Suhail 	/poets/aamir-suhail
Aanand Saroop Anjum 	/poets/aanand-saroop-anjum
Aanis Moin 	/poets/aanis-moin
Aarifuddin Aajiz 	/poets/aarifuddin-aajiz
Aas Fatmi 	/poets/aas-fatmi
Aashufta Changezi 	/poets/aashufta-changezi
Aasi Faiqi 	/poets/aasi-faiqi
Aasi Ghazipuri 	/poets/aasi-ghazipuri
Aasi Karnali 	/poets/aasi-karnali
Aasi Ramnagri 	/poets/aasi-ramnagri
Aasi uldani 	/poets/aasi-uldani
Aasim Shahnawaz Shibli 	/poets/aasim-shahnawaz-shibli
Aasnath Kanwal 	/poets/aasnath-kanwal
Aatif Kamal Rana 	/poets/aatif-kamal-rana
Aatif Waheed Yasir 	/poets/aatif-waheed-yasir
Aatish Bahawalpuri 	/poets/aatish-bahawalpuri
Aatish Indori 	/poets/aatish-indori
Aazam Khursheed 	/poets/aazam-khursheed
Aazim Kohli 	/poets/aazim-kohli
Abbas Ali Khan Bekhud 	/poets/abbas-ali-khan-bekhud
Abbas Alvi 	/poets/abbas-alvi
Abbas Athar 	/poets/abbas-athar
Abbas Dana 	/poets/abbas-dana
Abbas Kaifi 	/poets/abbas-kaifi
Abbas Qamar 	/poets/abbas-qamar
Abbas Rizvi 	/poets/abbas-rizvi
Abbas Tabish 	/poets/abbas-tabish
Abdul Ahad Saaz 	/poets/abdul-ahad-saaz
Abdul Aleem Aasi 	/poets/abdul-aleem-aasi
Abdul Aziz Fitrat 	/poets/abdul-aziz-fitrat
Abdul Aziz Khalid 	/poets/abdul-aziz-khalid
Abdul Ghafoor Nassakh 	/poets/abdul-ghafoor-nassakh
Abdul Hadi Wafa 	/poets/abdul-hadi-wafa
Abdul Hafeez Sahil Qadri 	/poets/abdul-hafeez-sahil-qadri
Abdul Hafiz Naeemi 	/poets/abdul-hafiz-naeemi
Abdul Halim Sharar 	/poets/abdul-halim-sharar
Abdul Hameed Saqi 	/poets/abdul-hameed-saqi
Abdul Hamid 	/poets/abdul-hamid
Abdul Hamid Adam 	/poets/abdul-hamid-adam
A G Josh 	/poets/a-g-josh
Aabida Urooj 	/poets/aabida-urooj
Aadil Raza Mansoori 	/poets/aadil-raza-mansoori
Aafaque Siddiqui 	/poets/aafaque-siddiqui
aaftaab-ud-Daula Lakhnavi Qalaq 	/poets/aaftaab-ud-daula-lakhnavi-qalaq
Aaftab Rais Panipati 	/poets/aaftab-rais-panipati
Aaga nisaar 	/poets/aaga-nisaar
Aagha Akbarabadi 	/poets/aagha-akbarabadi
Aal-e-Ahmad Suroor 	/poets/aal-e-ahmad-suroor
Aal-e-Raza Raza 	/poets/aal-e-raza-raza
Aalok Shrivastav 	/poets/aalok-shrivastav
Aamir Suhail 	/poets/aamir-suhail
Aanand Saroop Anjum 	/poets/aanand-saroop-anjum
Aanis Moin 	/poets/aanis-moin
Aarifuddin Aajiz 	/poets/aarifuddin-aajiz
Aas Fatmi 	/poets/aas-fatmi
Aashufta Changezi 	/poets/aashufta-changezi
Aasi Faiqi 	/poets/aasi-faiqi
Aasi Ghazipuri 	/poets/aasi-ghazipuri
Aasi Karnali 	/poets/aasi-karnali
Aasi Ramnagri 	/poets/aasi-ramnagri
Aasi uldani 	/poets/aasi-uldani
Aasim Shahnawaz Shibli 	/poets/aasim-shahnawaz-shibli
Aasnath Kanwal 	/poets/aasnath-kanwal
Aatif Kamal Rana 	/poets/aatif-kamal-rana
Aatif Waheed Yasir 	/poets/aatif-waheed-yasir
Aatish Bahawalpuri 	/poets/aatish-bahawalpuri
Aatish Indori 	/poets/aatish-indori
Aazam Khursheed 	/poets/aazam-khursheed
Aazim Kohli 	/poets/aazim-kohli
Abbas Ali Khan Bekhud 	/poets/abbas-ali-khan-bekhud
Abbas Alvi 	/poets/abbas-alvi
Abbas Athar 	/poets/abbas-athar
Abbas Dana 	/poets/abbas-dana
Abbas Kaifi 	/poets/abbas-kaifi
Abbas Qamar 	/poets/abbas-qamar
Abbas Rizvi 	/poets/abbas-rizvi
Abbas Tabish 	/poets/abbas-tabish
Abdul Ahad Saaz 	/poets/abdul-ahad-saaz
Abdul Aleem Aasi 	/poets/abdul-aleem-aasi
Abdul Aziz Fitrat 	/poets/abdul-aziz-fitrat
Abdul Aziz Khalid 	/poets/abdul-aziz-khalid
Abdul Ghafoor Nassakh 	/poets/abdul-ghafoor-nassakh
Abdul Hadi Wafa 	/poets/abdul-hadi-wafa
Abdul Hafeez Sahil Qadri 	/poets/abdul-hafeez-sahil-qadri
Abdul Hafiz Naeemi 	/poets/abdul-hafiz-naeemi
Abdul Halim Sharar 	/poets/abdul-halim-sharar
Abdul Hameed Saqi 	/poets/abdul-hameed-saqi
Abdul Hamid 	/poets/abdul-hamid
Abdul Hamid Adam 	/poets/abdul-hamid-adam
Abdul Majeed Bhatti 	/poets/abdul-majeed-bhatti
Abdul Majeed Hairat 	/poets/abdul-majeed-hairat
Abdul Majeed Khan Majeed 	/poets/abdul-majeed-khan-majeed
Abdul Majeed Salik 	/poets/abdul-majeed-salik
Abdul Malik Soz 	/poets/abdul-malik-soz
Abdul Mannan Samadi 	/poets/abdul-mannan-samadi
Abdul Mannan Tarzi 	/poets/abdul-mannan-tarzi
Abdul Mateen Niyaz 	/poets/abdul-mateen-niyaz
Abdul Qavi Ziya 	/poets/abdul-qavi-ziya
Abdul Rahman Bazmi 	/poets/abdul-rahman-bazmi
Abdul Rahman Ehsan Dehlvi 	/poets/abdul-rahman-ehsan-dehlvi
Abdul Rahman Khan Wasfi Bahraichi 	/poets/abdul-rahman-khan-wasfi-bahraichi
Abdul Rahman Rasikh 	/poets/abdul-rahman-rasikh
Abdul Salam 	/poets/abdul-salam
Abdul Wahab Sukhan 	/poets/abdul-wahab-sukhan
Abdul Wahab yakro 	/poets/abdul-wahab-yakro
Abdullah Javed 	/poets/abdullah-javed
Abdullah Kamal 	/poets/abdullah-kamal
Abdullateef Shauq 	/poets/abdullateef-shauq
Abdullla Khan Mehr Lakhnavi 	/poets/abdullla-khan-mehr-lakhnavi
Abdur Rahim Nashtar 	/poets/abdur-rahim-nashtar
Abdur Rasheed 	/poets/abdur-rasheed
Abdur Rauf Urooj 	/poets/abdur-rauf-urooj
abdurrahman momin 	/poets/abdurrahman-momin
Abdurrahman Wasif 	/poets/abdurrahman-wasif
Abdushshukoor Aasi 	/poets/abdushshukoor-aasi
Abdussamad ’Tapish’ 	/poets/abdussamad-tapish
Abhishek Kumar Amber 	/poets/abhishek-kumar-amber
Abhishek Shukla 	/poets/abhishek-shukla
Abid Akhtar 	/poets/abid-akhtar
Abid Almi 	/poets/abid-almi
Abid Hashri 	/poets/abid-hashri
Abid Karhani 	/poets/abid-karhani
Abid Kazmi 	/poets/abid-kazmi
Abid Khursheed 	/poets/abid-khursheed
Abid Malik 	/poets/abid-malik
Abid Munavari 	/poets/abid-munavari
Abid Nami 	/poets/abid-nami
Abid Siddiq 	/poets/abid-siddiq
Abid Syal 	/poets/abid-syal
Abid Wadood 	/poets/abid-wadood
Abr Ahsani Ganauri 	/poets/abr-ahsani-ganauri
Abrar Abid 	/poets/abrar-abid
Abrar Ahmad 	/poets/abrar-ahmad
Abrar Azmi 	/poets/abrar-azmi
Abrar Hamid 	/poets/abrar-hamid
Abrar Kiratpuri 	/poets/abrar-kiratpuri
Abrar Shahjahanpuri 	/poets/abrar-shahjahanpuri
Abrarul Hasan 	/poets/abrarul-hasan
Abroo Shah Mubarak 	/poets/abroo-shah-mubarak
Absar Abdul Ali 	/poets/absar-abdul-ali
Abu Bakr Abbad 	/poets/abu-bakr-abbad
Abu Mohammad Sahar 	/poets/abu-mohammad-sahar
Abu Mohammad Wasil 	/poets/abu-mohammad-wasil
Abu Turab 	/poets/abu-turab
Abu Zahid Sayyad Yahya Husaini Qadr 	/poets/abu-zahid-sayyad-yahya-husaini-qadr
Abul Hasanat Haqqi 	/poets/abul-hasanat-haqqi
Abul Kalam Azad 	/poets/abul-kalam-azad
Abul Mujahid Zahid 	/poets/abul-mujahid-zahid
Ada Jafarey 	/poets/ada-jafarey
Adeeb Khalwat 	/poets/adeeb-khalwat
Adeeb Saharanpuri 	/poets/adeeb-saharanpuri
Adeeb Suhail 	/poets/adeeb-suhail
Adeel Zaidi 	/poets/adeel-zaidi
Adeem Hashmi 	/poets/adeem-hashmi
Adil Faridi 	/poets/adil-faridi
Adil Hayat 	/poets/adil-hayat
Adil Mansuri 	/poets/adil-mansuri
Adil Rasheed 	/poets/adil-rasheed
Aditya Pant Naaqid 	/poets/aditya-pant-naaqid
Afeef Siraj 	/poets/afeef-siraj
Afkar Mohani 	/poets/afkar-mohani
Afroz Alam 	/poets/afroz-alam
Afroz Talib 	/poets/afroz-talib
Afsar Allahabadi 	/poets/afsar-allahabadi
Afsar Azri 	/poets/afsar-azri
Afsar Jamshed 	/poets/afsar-jamshed
Afsar Mahpuri 	/poets/afsar-mahpuri
Afsar Merathi 	/poets/afsar-merathi
Aftab Ahmad 	/poets/aftab-ahmad
Aftab Ahmad Shah 	/poets/aftab-ahmad-shah
Aftab Arif 	/poets/aftab-arif
Aftab Hussain 	/poets/aftab-hussain
Aftab Iqbal Shamim 	/poets/aftab-iqbal-shamim
Aftab Shah Alam Sani 	/poets/aftab-shah-alam-sani
Aftab Shakeel 	/poets/aftab-shakeel
Aftab Shamsi 	/poets/aftab-shamsi
Afzaal Firdaus 	/poets/afzaal-firdaus
Afzal Ahmad Syed 	/poets/afzal-ahmad-syed
Afzal Allahabadi 	/poets/afzal-allahabadi
Afzal Alvi 	/poets/afzal-alvi
Afzal Gauhar Rao 	/poets/afzal-gauhar-rao
Afzal Hazarvi 	/poets/afzal-hazarvi
Afzal Khan 	/poets/afzal-khan
Afzal Minhas 	/poets/afzal-minhas
Afzal Naved 	/poets/afzal-naved
Afzal Parvez 	/poets/afzal-parvez
Afzal Peshawari 	/poets/afzal-peshawari
Agha Hajju Sharaf 	/poets/agha-hajju-sharaf
Agha Hashr Kashmiri 	/poets/agha-hashr-kashmiri
Agha Mohammad Taqi Khan taraqqi 	/poets/agha-mohammad-taqi-khan-taraqqi
Agha Shayar Qazalbash 	/poets/agha-shayar-qazalbash
Aghaa Shair 	/poets/aghaa-shair
Aghaz Barni 	/poets/aghaz-barni
Aghaz Buldhanwi 	/poets/aghaz-buldhanwi
Ahmad Ali Barqi Azmi 	/poets/ahmad-ali-barqi-azmi
Ahmad Alvi 	/poets/ahmad-alvi
Ahmad Ashfaq 	/poets/ahmad-ashfaq
Ahmad Ata 	/poets/ahmad-ata
Ahmad Azad 	/poets/ahmad-azad
Ahmad Azeem 	/poets/ahmad-azeem
Ahmad Azimabadi 	/poets/ahmad-azimabadi
Ahmad Fakhir 	/poets/ahmad-fakhir
Ahmad Faqih 	/poets/ahmad-faqih
Ahmad Faraz 	/poets/ahmad-faraz
Ahmad Fareed 	/poets/ahmad-fareed
Ahmad Farhad 	/poets/ahmad-farhad
Ahmad Hamdani 	/poets/ahmad-hamdani
Ahmad Hamesh 	/poets/ahmad-hamesh
Ahmad Husain Mail 	/poets/ahmad-husain-mail
Ahmad Husain Mujahid 	/poets/ahmad-husain-mujahid
Ahmad Jahangeer 	/poets/ahmad-jahangeer
Ahmad Javed 	/poets/ahmad-javed
Ahmad Kamal Hashmi 	/poets/ahmad-kamal-hashmi
Ahmad Kamal Parwazi 	/poets/ahmad-kamal-parwazi
Ahmad Kamran 	/poets/ahmad-kamran
Ahmad Khayal 	/poets/ahmad-khayal
Ahmad Lateef 	/poets/ahmad-lateef
Ahmad Mahfuz 	/poets/ahmad-mahfuz
Ahmad Masoom 	/poets/ahmad-masoom
Ahmad Mushtaq 	/poets/ahmad-mushtaq
Ahmad Nadeem Qasmi 	/poets/ahmad-nadeem-qasmi
Ahmad Rahi 	/poets/ahmad-rahi
Ahmad Razi Bachhrayuni 	/poets/ahmad-razi-bachhrayuni
Ahmad Riyaz 	/poets/ahmad-riyaz
Ahmad Rizwan 	/poets/ahmad-rizwan
Ahmad Sagheer Siddiqui 	/poets/ahmad-sagheer-siddiqui
Ahmad Sajjad Babar 	/poets/ahmad-sajjad-babar
Ahmad Salman 	/poets/ahmad-salman
Ahmad Shahid Khan 	/poets/ahmad-shahid-khan
Ahmad Shahryar 	/poets/ahmad-shahryar
Ahmad Shanas 	/poets/ahmad-shanas
Ahmad Soz 	/poets/ahmad-soz
Ahmad Tanvir 	/poets/ahmad-tanvir
Ahmad Waheed Akhtar 	/poets/ahmad-waheed-akhtar
Ahmad Wasi 	/poets/ahmad-wasi
Ahmad Zafar 	/poets/ahmad-zafar
Ahmad Ziya 	/poets/ahmad-ziya
Ahmaq Phaphoondvi 	/poets/ahmaq-phaphoondvi
Ahmed Ataullah 	/poets/ahmed-ataullah
Ahmed Nisar 	/poets/ahmed-nisar
Ahmed Shamim 	/poets/ahmed-shamim
Ahsan Ahmad Ashk 	/poets/ahsan-ahmad-ashk
Ahsan Imam Ahsan 	/poets/ahsan-imam-ahsan
Ahsan Lakhnavi 	/poets/ahsan-lakhnavi
Ahsan Marahravi 	/poets/ahsan-marahravi
Ahsan Rizvi Danapuri 	/poets/ahsan-rizvi-danapuri
Ahsan Saleem 	/poets/ahsan-saleem
Ahsan Shafiq 	/poets/ahsan-shafiq
Ahsan Yusuf Zai 	/poets/ahsan-yusuf-zai
Ain Irfan 	/poets/ain-irfan
Ain Rashid 	/poets/ain-rashid
Ain Salam 	/poets/ain-salam
Ain Tabish 	/poets/ain-tabish
Ainuddin Azim 	/poets/ainuddin-azim
Aish Barni 	/poets/aish-barni
Aish Dehlvi 	/poets/aish-dehlvi
Ajay Sahaab 	/poets/ajay-sahaab
Ajeet Kumar Dil 	/poets/ajeet-kumar-dil
Ajeet Singh Hasrat 	/poets/ajeet-singh-hasrat
Ajiz Kamaal Rana  new	/poets/ajiz-kamaal-rana
Ajiz Matvi 	/poets/ajiz-matvi
Ajmal Ajmali 	/poets/ajmal-ajmali
Ajmal Siddiqi 	/poets/ajmal-siddiqi
Ajmal Siraj 	/poets/ajmal-siraj
Akbar Ali Khan Arshi Zadah 	/poets/akbar-ali-khan-arshi-zadah
Akbar Allahabadi 	/poets/akbar-allahabadi
Akbar Haidri 	/poets/akbar-haidri
Akbar Hameedi 	/poets/akbar-hameedi
Akbar Husain Mohani Ibrat 	/poets/akbar-husain-mohani-ibrat
Akbar Hyderabadi 	/poets/akbar-hyderabadi
Akbar Kazmi 	/poets/akbar-kazmi
Akbar Masoom 	/poets/akbar-masoom
Akhgar Mushtaq Raheem Aabadi 	/poets/akhgar-mushtaq-raheem-aabadi
Akhilesh Tiwari 	/poets/akhilesh-tiwari
Akhlaq Aatif 	/poets/akhlaq-aatif
Akhlaq Ahmad Ahan 	/poets/akhlaq-ahmad-ahan
Akhlaque Bandvi 	/poets/akhlaque-bandvi
Akhtar Ali Akhtar 	/poets/ali-akhtar-akhtar
Akhtar Amaan 	/poets/akhtar-amaan
Akhtar Ansari 	/poets/akhtar-ansari
Akhtar Ansari Akbarabadi 	/poets/akhtar-ansari-akbarabadi
Akhtar Azad 	/poets/akhtar-azad-1
Akhtar Bastavi 	/poets/akhtar-bastavi
Akhtar Feroz 	/poets/akhtar-feroz
Akhtar Hashmi 	/poets/akhtar-hashmi
Akhtar Hoshiyarpuri 	/poets/akhtar-hoshiyarpuri
Akhtar Husain Jafri 	/poets/akhtar-husain-jafri
Akhtar Imam Rizvi 	/poets/akhtar-imam-rizvi
Akhtar lakhnvi 	/poets/akhtar-lakhnvi
akhtar malik 	/poets/akhtar-malik
Akhtar Muslimi 	/poets/akhtar-muslimi
Akhtar Nazmi 	/poets/akhtar-nazmi
Akhtar Orenvi 	/poets/akhtar-orenvi
Akhtar Payami 	/poets/akhtar-payami
Akhtar Rahi 	/poets/akhtar-rahi
Akhtar Raza Adeel 	/poets/akhtar-raza-adeel
Akhtar Razaa Saleemi 	/poets/akhtar-razaa-saleemi
Akhtar Saeed 	/poets/akhtar-saeed
Akhtar Saeed Khan 	/poets/akhtar-saeed-khan
Akhtar Saeedi 	/poets/akhtar-saeedi
Akhtar Shahjahanpuri 	/poets/akhtar-shahjahanpuri
Akhtar Sheikh 	/poets/akhtar-sheikh
Akhtar Shirani 	/poets/akhtar-shirani
Akhtar Shumar 	/poets/akhtar-shumar
Akhtar Siddiqui 	/poets/akhtar-siddiqui
Akhtar Usman 	/poets/akhtar-usman
Akhtar Yusuf 	/poets/akhtar-yusuf
Akhtar Ziai 	/poets/akhtar-ziai
Akhtar-ul-Iman 	/poets/akhtar-ul-iman
Akmal Imaam 	/poets/akmal-imaam
Akram Mahmud 	/poets/akram-mahmud
Akram Naqqash 	/poets/akram-naqqash
Aks samastipuri 	/poets/aks-samastipuri
Alam Khursheed 	/poets/alam-khursheed
Alam Muzaffar Nagari 	/poets/alam-muzaffar-nagari
Alam Rahat 	/poets/alam-rahat
Alamtaab Tishna 	/poets/alamtaab-tishna
Aleem Afsar 	/poets/aleem-afsar
Aleem Akhtar 	/poets/aleem-akhtar
Aleem Durrani 	/poets/aleem-durrani
Aleem Masroor 	/poets/aleem-masroor
Aleem Saba Navedi 	/poets/aleem-saba-navedi
Aleem Usmani 	/poets/aleem-usmani
Aleena Itrat 	/poets/aleena-itrat
Ali Abbas Ummeed 	/poets/ali-abbas-ummeed
Ali Ahmad Jalili 	/poets/ali-ahmad-jalili
Ali Akbar Abbas 	/poets/ali-akbar-abbas
Ali Akbar Mansoor 	/poets/ali-akbar-mansoor
Ali Akbar Natiq 	/poets/ali-akbar-natiq
Ali Arman 	/poets/ali-arman
Ali Asghar 	/poets/ali-asghar
Ali Asghar Abbas 	/poets/ali-asghar-abbas
Ali Iftikhar Jafri 	/poets/ali-iftikhar-jafri
Ali Imran 	/poets/ali-imran
Ali Jawwad Zaidi 	/poets/ali-jawwad-zaidi
Ali Khan Jauhar 	/poets/ali-khan-jauhar
Ali Manzoor Hyderabadi 	/poets/ali-manzoor-hyderabadi
Ali Mohammad Farshi 	/poets/ali-mohammad-farshi
Ali Muthar Ashar 	/poets/ali-muthar-ashar
Ali Muzammil 	/poets/ali-muzammil
Ali Sahil 	/poets/ali-sahil
Ali Sardar Jafri 	/poets/ali-sardar-jafri
Ali Sarmad 	/poets/ali-sarmad
Ali Wijdan 	/poets/ali-wijdan
Ali Yasir 	/poets/ali-yasir
Ali Zaheer Lakhnavi 	/poets/ali-zaheer-lakhnavi
Ali Zaryoun 	/poets/ali-zaryoun
Ali Zubair 	/poets/ali-zubair
Alimullah 	/poets/alimullah
Alimullah Hali 	/poets/alimullah-hali
Aliuddeen Naved 	/poets/aliuddeen-naved
Alka Mishra 	/poets/alka-mishra
All Imran 	/poets/all-imran
Allama Iqbal 	/poets/allama-iqbal
Almas Shabi 	/poets/almas-shabi
Alok Mishra 	/poets/alok-mishra
Alok Yadav 	/poets/alok-yadav
Alqama Shibli 	/poets/alqama-shibli
Altaf Ahmad Qureshi 	/poets/altaf-ahmad-qureshi
Altaf Gauhar 	/poets/altaf-gauhar
Altaf Hussain Hali 	/poets/altaf-hussain-hali
Altaf Mashhadi 	/poets/altaf-mashhadi
Altaf Parwaz 	/poets/altaf-parwaz
Amanat Lakhnavi 	/poets/amanat-lakhnavi
Amanullah Khalid 	/poets/amanullah-khalid
Amar Singh Figar 	/poets/amar-singh-figar
Ambar Bahraichi 	/poets/ambar-bahraichi
Ambar Kharbanda 	/poets/ambar-kharbanda
Ambar Shameem 	/poets/ambar-shameem
Ambareen Haseeb ambar 	/poets/ambareen-haseeb-ambar
Ambarin Salahuddin 	/poets/ambarin-salahuddin
Amber Joshi 	/poets/amber-joshi
Amber Waseem Allahabadi 	/poets/amber-waseem-allahabadi
Ameen Adirai 	/poets/ameen-adirai
Ameen Hazin 	/poets/ameen-hazin
Ameen Rahat Chugtai 	/poets/ameen-rahat-chugtai
Ameen Saloni 	/poets/ameen-saloni
Ameeq Hanafi 	/poets/ameeq-hanafi
Ameer Ahmad Khusro 	/poets/ameer-ahmad-khusro
Ameer Aurangabadi 	/poets/ameer-aurangabadi
Ameer Imam 	/poets/ameer-imam
Ameer Khusrau 	/poets/ameer-khusrau
Ameer Minai 	/poets/ameer-minai
Ameer Qazalbash 	/poets/ameer-qazalbash
Ameeta Parsuram ‘Meeta’ 	/poets/ameeta-parsuram-meeta
Amir Ameer 	/poets/amir-ameer
Amir Hamza Saqib 	/poets/amir-hamza-saqib
Amir Mausavi 	/poets/amir-mausavi
Amir Nazar 	/poets/amir-nazar
Amir Riyaz 	/poets/amir-riyaz
Amir Usmani 	/poets/amir-usmani
Amirullah Tasleem 	/poets/amirullah-tasleem
Amit Ahad 	/poets/amit-ahad
Amit Brij sha 	/poets/amit-brij-sha
Amit Satpal Tanwar  new	/poets/amit-satpal-tanwar
Amit Sharma Meet 	/poets/amit-sharma-meet
Amitabh Bachchan 	/poets/amitabh-bachchan
Amjad hyderabadi 	/poets/amjad-hyderabadi-1
Amjad Islam Amjad 	/poets/amjad-islam-amjad
Amjad Najmi 	/poets/amjad-najmi
Amjad Shahzad 	/poets/amjad-shahzad
Ammar Iqbal 	/poets/ammar-iqbal
Amrit Lal Ishrat 	/poets/amrit-lal-ishrat
Anand Narayan Mulla 	/poets/anand-narayan-mulla
Andaleeb Shadani 	/poets/andaleeb-shadani
Anees Ahmad Anees 	/poets/anees-ahmad-anees
Anees Ansari 	/poets/anees-ansari
Anees Ashfaq 	/poets/anees-ashfaq
Anees Kaifi 	/poets/anees-kaifi
Anees Nagi 	/poets/anees-nagi
Anis Abr 	/poets/anis-abr
Anis Dehlavi 	/poets/anis-dehlavi
Anisa Begum 	/poets/anisa-begum
Anjana Sandhir 	/poets/anjaana-sandhir
Anjum Abbasi 	/poets/anjum-abbasi
Anjum Ansari 	/poets/anjum-ansari
Anjum Azimabadi 	/poets/anjum-azimabadi
Anjum Azmi 	/poets/anjum-azmi
Anjum Barabankvi 	/poets/anjum-barabankvi
Anjum Fauqi Badayuni 	/poets/anjum-fauqi-badayuni
Anjum Irfani 	/poets/anjum-irfani
Anjum Khaleeq 	/poets/anjum-khaleeq
Anjum Khayali 	/poets/anjum-khayali
Anjum Ludhianvi 	/poets/anjum-ludhianvi
Anjum Manpuri 	/poets/anjum-manpuri
Anjum Niyazi 	/poets/anjum-niyazi
Anjum Rehbar 	/poets/anjum-rehbar
Anjum Rizwani 	/poets/anjum-rizwani
Anjum Rumani 	/poets/anjum-rumani
Anjum Saleemi 	/poets/anjum-saleemi
Anjum Siddiqui 	/poets/anjum-siddiqui
Anjum Tarazi 	/poets/anjum-tarazi
Ankit Gautam 	/poets/ankit-gautam
Ankita Garg 	/poets/ankita-garg
Ansar Ali Ansar 	/poets/ansar-ali-ansar
Anubhav Gupta 	/poets/anubhav-gupta
Anvar Kaifi 	/poets/anvar-kaifi
Anvar Mahmood Khalid 	/poets/anvar-mahmood-khalid
Anvar Moazzam 	/poets/anvar-moazzam
Anwar Aleemi 	/poets/anwar-aleemi
Anwar Anjum 	/poets/anwar-anjum
Anwar Barelvi 	/poets/anwar-barelvi
Anwar Dehlvi 	/poets/anwar-dehlvi
Anwar Feroz 	/poets/anwar-feroz
Anwar Fitrat 	/poets/anwar-fitrat
Anwar Habeeb 	/poets/anwar-habeeb
Anwar Jalalpuri 	/poets/anwar-jalalpuri
Anwar Jamal Anwar 	/poets/anwar-jamal-anwar
Anwar Khalil 	/poets/anwar-khalil
Anwar Khan 	/poets/anwar-khan-3
Anwar Maqsood Zahidi 	/poets/anwar-maqsood-zahidi
Anwar Masood 	/poets/anwar-masood
Anwar Minai 	/poets/anwar-minai
Anwar Mirzapuri 	/poets/anwar-mirzapuri
Anwar Nadim 	/poets/anwar-nadim
Anwar Sabri 	/poets/anwar-sabri
Anwar Sadeed 	/poets/anwar-sadeed
Anwar Saharanpuri 	/poets/anwar-saharanpuri
Anwar Sen Roy 	/poets/anwar-sen-roy
Anwar Shadani 	/poets/anwar-shadani
Anwar Shuoor 	/poets/anwar-shuoor
Anwar Siddiqui 	/poets/anwar-siddiqui
Anwar Taban 	/poets/anwar-taban
Anwari Jahan Begum Hijab 	/poets/anwari-jahan-begum-hijab
Anwarul Hasan Anwar 	/poets/anwarul-hasan-anwar
Aqeel Abbas 	/poets/aqeel-abbas
Aqeel Abbas Jafri 	/poets/aqeel-abbas-jafri
Aqeel Danish 	/poets/aqeel-danish
Aqeel Jamid 	/poets/aqeel-jamid
aqeel nomani 	/poets/aqeel-nomani
Aqeel Shadab 	/poets/aqeel-shadab
Aqib Sabir 	/poets/aqib-sabir
Aradhana Prasad 	/poets/aradhana-prasad
Arif Abbas 	/poets/arif-abbas
Arif Abbasi 	/poets/arif-abbasi
Arif Abdul Mateen 	/poets/arif-abdul-mateen
Arif Ansari 	/poets/arif-ansari
Arif Farhad 	/poets/arif-farhad
Arif Hasan Khan 	/poets/arif-hasan-khan
Arif Imam 	/poets/arif-imam
Arif Ishtiaque 	/poets/arif-ishtiaque
Arif Shafiq 	/poets/arif-shafiq
Arifa Shahzad 	/poets/arifa-shahzad
Arjumand Bano Afshan 	/poets/arjumand-bano-afshan
Arman Najmi 	/poets/arman-najmi
Arpit Sharmaa Arpit 	/poets/arpit-sharmaa-arpit
Arsh Malsiyani 	/poets/arsh-malsiyani
Arsh Sahbai 	/poets/arsh-sahbai
Arsh Siddiqui 	/poets/arsh-siddiqui
Arshad Abdul Hamid 	/poets/arshad-abdul-hamid
Arshad Ali Khan Qalaq 	/poets/arshad-ali-khan-qalaq
Arshad Jamal Hashmi 	/poets/arshad-jamal-hashmi
Arshad Jamal Sarim 	/poets/arshad-jamal-sarim
Arshad Kakvi 	/poets/arshad-kakvi
Arshad Kamal 	/poets/arshad-kamal
Arshad Lateef 	/poets/arshad-lateef
Arshad Mahmood Arshad 	/poets/arshad-mahmood-arshad
Arshad Mahmood Nashad 	/poets/arshad-mahmood-nashad
Arshad Malik 	/poets/arshad-malik
Arshad Meraj 	/poets/arshad-meraj
Arshad Nayeem 	/poets/arshad-nayeem
Arshad Siddiqui 	/poets/arshad-siddiqui
Arshadul Qadri 	/poets/arshadul-qadri
Arshi Bhopali 	/poets/arshi-bhopali
Arshi Rampuri 	/poets/arshi-rampuri
Arun Kumar Arya 	/poets/arun-kumar-arya
Arzoo Lakhnavi 	/poets/arzoo-lakhnavi
Arzoo Saharanpuri 	/poets/arzoo-saharanpuri
Asad Badayuni 	/poets/asad-badayuni
Asad Bhopali 	/poets/asad-bhopali
Asad Jafri 	/poets/asad-jafri
Asad Multani 	/poets/asad-multani
Asad Raza 	/poets/asad-raza
Asar Akbarabadi 	/poets/asar-akbarabadi
Asar Lakhnavi 	/poets/asar-lakhnavi
Asar Rampuri 	/poets/asar-rampuri
Asar Sahbai 	/poets/asar-sahbai
Aseer Lakhnawi 	/poets/aseer-lakhnawi
Asghar Abid 	/poets/asghar-abid
Asghar Gondvi 	/poets/asghar-gondvi
Asghar Gorakhpuri 	/poets/asghar-gorakhpuri
Asghar Mehdi Hosh 	/poets/asghar-mehdi-hosh
Asghar Nadeem Sayed 	/poets/asghar-nadeem-sayed
Asghar Rahi 	/poets/asghar-rahi
Asghar Saleem 	/poets/asghar-saleem
Asghar Shamim 	/poets/asghar-shamim
Asghar Velori 	/poets/asghar-velori
Asha Parbhat 	/poets/asha-parbhat
Ashar Hashmi 	/poets/ashar-hashmi
Ashar Najmi 	/poets/ashar-najmi
Ashfaq Amir 	/poets/ashfaq-amir
Ashfaq Husain 	/poets/ashfaq-husain
Ashfaq Nasir 	/poets/ashfaq-nasir
Ashfaq Rasheed Mansuri 	/poets/ashfaq-rasheed-mansuri
Ashfaq Rehbar 	/poets/ashfaq-rehbar
Ashfaque Anjum 	/poets/ashfaque-anjum
Ashhad Bilal Ibn-e-chaman 	/poets/ashhad-bilal-ibn-e-chaman
Ashique Akbarabadi 	/poets/ashique-akbarabadi
ashir Wakeel Rav 	/poets/ashir-wakeel-rav
Ashk Amritsari 	/poets/ashk-amritsari
Ashk Rampuri 	/poets/ashk-rampuri
Ashok Lal 	/poets/ashok-lal
Ashok Mizaj Badr 	/poets/ashok-mizaj-badr
Ashok Sahil 	/poets/ashok-sahil
Ashok Sawhny 	/poets/ashok-sawhny
Ashok Sawhny Sahil 	/poets/ashok-sawhny-sahil
Ashraf  Naqvi 	/poets/ashraf-naqvi
Ashraf Ali Ashraf 	/poets/ashraf-ali-ashraf
Ashraf Ali Fughan 	/poets/ashraf-ali-fughan
Ashraf Javed 	/poets/ashraf-javed
Ashraf Rafi 	/poets/ashraf-rafi
Ashraf Saleem 	/poets/ashraf-saleem
Ashraf Shad 	/poets/ashraf-shad
Ashraf Yusuf 	/poets/ashraf-yusuf
Ashu mishra 	/poets/ashu-mishra
Asif Aman Saifi 	/poets/asif-aman-saifi
Asif Anjum 	/poets/asif-anjum
Asif Jamal 	/poets/asif-jamal
Asif Rasheed Asjad 	/poets/asif-rasheed-asjad
Asif Raza 	/poets/asif-raza
Asif Saqib 	/poets/asif-saqib
Asif Shafi 	/poets/asif-shafi
Asifa Nishat 	/poets/asifa-nishat
Asifa Zamani 	/poets/asifa-zamani
Asif-ud-Daula 	/poets/asif-ud-daula
Asim Wasti 	/poets/asim-wasti
Asima Tahir 	/poets/asima-tahir
Aslam Ansari 	/poets/aslam-ansari
Aslam Azad 	/poets/aslam-azad
Aslam Badar 	/poets/aslam-badar
Aslam Emadi 	/poets/aslam-emadi
Aslam Faizi 	/poets/aslam-faizi
Aslam Farrukhi 	/poets/aslam-farrukhi
Aslam Habeeb 	/poets/aslam-habeeb
Aslam Haneef 	/poets/aslam-haneef
Aslam Kolsarii 	/poets/aslam-kolsarii
Aslam Mahmood 	/poets/aslam-mahmood
Aslam Rashid 	/poets/aslam-rashid
Asra Rizvi 	/poets/asra-rizvi
Asrar Akbarabadi 	/poets/asrar-akbarabadi
Asrar jaamayee 	/poets/asrar-jaamayee
Asrar Zaidi 	/poets/asrar-zaidi
Asrarul Haq Asrar 	/poets/asrarul-haq-asrar
Asrar-ul-Haq Majaz 	/poets/asrar-ul-haq-majaz
Ata Abidi 	/poets/ata-abidi
Ata Husain Kaleem 	/poets/ata-husain-kaleem
Ata Shad 	/poets/ata-shad
Ata Turab 	/poets/ata-turab
Ata ul Haq Qasmi 	/poets/ata-ul-haq-qasmi
Atal Bihari Vajpayee 	/poets/atal-bihari-vajpayee
Ataul Hasan 	/poets/ataul-hasan
Ataur Rahman Jameel 	/poets/ataur-rahman-jameel
Ataurrahman Qazi 	/poets/ataurrahman-qazi
Ateeq Ahmad 	/poets/ateeq-ahmad-1
Ateeq Allahabadi 	/poets/ateeq-allahabadi
Ateeq Anzar 	/poets/ateeq-anzar
Ateeq Asar 	/poets/ateeq-asar
Ateeq Muzaffarpuri 	/poets/ateeq-muzaffarpuri
Ateeya Daud 	/poets/ateeya-daud
Ateeya Niyazi 	/poets/ateeya-niyazi
Athar Adeeb 	/poets/athar-adeeb
Athar Aziz 	/poets/athar-aziz
Athar Nadir 	/poets/athar-nadir
Athar Nafees 	/poets/athar-nafees
Athar Nasik 	/poets/athar-nasik
Athar Raz 	/poets/athar-raz
Athar Saleemi 	/poets/athar-saleemi
athar shakeel 	/poets/athar-shakeel
Atif Khan 	/poets/atif-khan
Atiiqullah 	/poets/atiiqullah
Atiq Ur Rehman Safi 	/poets/atiq-ur-rehman-safi
Atul Ajnabi 	/poets/atul-ajnabi
Atyab Ejaz 	/poets/atyab-ejaz
Auj lakhnavi 	/poets/auj-lakhnavi
Aulad Ali Rizvi 	/poets/aulad-ali-rizvi
Aurang zeb 	/poets/aurang-zeb
Ayaz Ahmad Talib 	/poets/ayaz-ahmad-talib
Ayaz Jhansvi 	/poets/ayaz-jhansvi
Ayaz Mahmood Ayaz 	/poets/ayaz-mahmood-ayaz
Ayaz Rasool Nazki  new	/poets/ayaz-rasool-nazki
Ayesha Masood Malik 	/poets/ayesha-masood-malik
Ayub Jauhar 	/poets/ayub-jauhar
Ayub Khawar 	/poets/ayub-khawar
Ayub Rumani 	/poets/ayub-rumani
Ayub Sabir 	/poets/ayub-sabir
Ayush Charag 	/poets/ayush-charag
Azad Ansari 	/poets/azad-ansari
Azad Gulati 	/poets/azad-gulati
Azad Gurdaspuri 	/poets/azad-gurdaspuri
Azad Husain Azad 	/poets/azad-husain-azad
Azam Chishti 	/poets/azam-chishti
Azam Jalalabadi 	/poets/azam-jalalabadi
Azar Tamanna 	/poets/azar-tamanna
Azeem Murtaza 	/poets/azeem-murtaza
Azeem Qureshi 	/poets/azeem-qureshi
Azeemuddin Ahmad 	/poets/azeemuddin-ahmad
Azeez Prihar 	/poets/azeez-prihar
Azhar Abbas 	/poets/azhar-abbas
Azhar Adeeb 	/poets/azhar-adeeb
Azhar Ali 	/poets/azhar-ali
Azhar Faragh 	/poets/azhar-faragh
Azhar Ghauri 	/poets/azhar-ghauri
Azhar Hashmi 	/poets/azhar-hashmi
Azhar Inayati 	/poets/azhar-inayati
Azhar Iqbal 	/poets/azhar-iqbal
Azhar Javed 	/poets/azhar-javed
Azhar Lakhnawi 	/poets/azhar-lakhnawi
Azhar Naiyyar 	/poets/azhar-naiyyar
Azhar Naqvi 	/poets/azhar-naqvi
Azhar Nawaz 	/poets/azhar-nawaz
Azhar Qadiri 	/authors/azhar-qadiri
Azhar Saeed 	/poets/azhar-saeed
Azim Haidar Syed 	/poets/azim-haidar-syed
Aziz Ahmad 	/poets/aziz-ahmad
Aziz Ahmad Khan Shafaq 	/poets/aziz-ahmad-khan-shafaq
Aziz Ansari 	/poets/aziz-ansari
Aziz Badayuni 	/poets/aziz-badayuni
Aziz Bano Darab  Wafa 	/poets/aziz-bano-darab-wafa
Aziz Ejaz 	/poets/aziz-ejaz
Aziz Faisal 	/poets/aziz-faisal
Aziz Hamid Madni 	/poets/aziz-hamid-madni
Aziz Hyderabadi 	/poets/aziz-hyderabadi
Aziz Lakhnavi 	/poets/aziz-lakhnavi
Aziz Nabeel 	/poets/aziz-nabeel
Aziz Qaisi 	/poets/aziz-qaisi
Aziz Sabri 	/poets/aziz-sabri
Aziz Tamannai 	/poets/aziz-tamannai
Aziz Warsi 	/poets/aziz-warsi
Aziz-ur-Rahman Shaheed Fatehpuri 	/poets/aziz-ur-rahman-shaheed-fatehpuri
Azlan shah 	/poets/azlan-shah
Azm Bahzad 	/poets/azm-bahzad
Azm Shakri 	/poets/azm-shakri
Azmatullah Khan 	/poets/azmatullah-khan
Azra Abbas 	/poets/azra-abbas
Azra Naqvi 	/poets/azra-naqvi
Azra Parveen 	/poets/azra-parveen
Azra Waheed 	/poets/azra-waheed
Azraq Adeem 	/poets/azraq-adeem
B S Jain Jauhar 	/poets/b-s-jain-jauhar
Babar Rahman Shah 	/poets/babar-rahman-shah
Badar Jamali 	/poets/badar-jamali
Badiuzzama Khawar 	/poets/badiuzzama-khawar
Badnam Nazar 	/poets/badnam-nazar
Badr Wasti 	/poets/badr-wasti
Badr-e-Alam Khalish 	/poets/badr-e-alam-khalish
Bagh Husain Kamal 	/poets/bagh-husain-kamal
Bahadur Shah Zafar 	/poets/bahadur-shah-zafar
Bahram ji 	/poets/bahram-ji
Bahram Tariq 	/poets/bahram-tariq
Bakhsh Layalpuri 	/poets/bakhsh-layalpuri
Bakhtiyar Ziya 	/poets/bakhtiyar-ziya
Bakul Dev 	/poets/bakul-dev
Balbir Rathi 	/poets/balbir-rathi
Balraj Bakshi 	/poets/balraj-bakshi
Balraj Hayat 	/poets/balraj-hayat
Balraj Komal 	/poets/balraj-komal
Balwan Singh Azar 	/poets/balwan-singh-azar
Bano Bee 	/poets/bano-bee
Bano Tahira Sayeed 	/poets/bano-tahira-sayeed
Baqa Baluch 	/poets/baqa-baluch
Baqar Agah Vellori 	/poets/baqar-agah-vellori
Baqar Mehdi 	/poets/baqar-mehdi
Baqar Naqvi 	/poets/baqar-naqvi
Baqaullah 'Baqa' 	/poets/baqaullah-baqa
Baqi Ahmad Puri 	/poets/baqi-ahmad-puri
Baqi Siddiqui 	/poets/baqi-siddiqui
Barq Dehlvi 	/poets/barq-dehlvi
Barq Hyderabadi 	/poets/barq-hyderabadi
Bashar Nawaz 	/poets/bashar-nawaz
Basheer Ahmad Basheer 	/poets/basheer-ahmad-basheer
Basheer Ahmad Shad 	/poets/basheer-ahmad-shad
Basheer Dada 	/authors/basheer-dada
Basheer Munzir 	/poets/basheer-munzir
Basheeruddin Raaz 	/poets/basheeruddin-raaz
Basheer-un-Nisa Begum Barq 	/poets/basheer-un-nisa-begum-barq
Bashir Badr 	/poets/bashir-badr
Bashir Farooq 	/poets/bashir-farooq
Bashir Farooqi 	/poets/bashir-farooqi
Bashir Mehtaab 	/poets/bashir-mehtaab
Bashir Saifi 	/poets/bashir-saifi
Bashir Zaidi Aseer 	/poets/bashir-zaidi-aseer
Bashiruddin Ahmad Dehlvi 	/poets/bashiruddin-ahmad-dehlvi
Basir Sultan Kazmi 	/poets/basir-sultan-kazmi
Basit Bhopali 	/poets/basit-bhopali
Bayan Ahsanullah Khan 	/poets/bayan-ahsanullah-khan
Bayan Meeruti 	/poets/bayan-meeruti
Bayan Yazdani 	/poets/bayan-yazdani
Bebak  Bhojpuri 	/poets/bebak-bhojpuri
B S Jain Jauhar 	/poets/b-s-jain-jauhar
Babar Rahman Shah 	/poets/babar-rahman-shah
Badar Jamali 	/poets/badar-jamali
Badiuzzama Khawar 	/poets/badiuzzama-khawar
Badnam Nazar 	/poets/badnam-nazar
Badr Wasti 	/poets/badr-wasti
Badr-e-Alam Khalish 	/poets/badr-e-alam-khalish
Bagh Husain Kamal 	/poets/bagh-husain-kamal
Bahadur Shah Zafar 	/poets/bahadur-shah-zafar
Bahram ji 	/poets/bahram-ji
Bahram Tariq 	/poets/bahram-tariq
Bakhsh Layalpuri 	/poets/bakhsh-layalpuri
Bakhtiyar Ziya 	/poets/bakhtiyar-ziya
Bakul Dev 	/poets/bakul-dev
Balbir Rathi 	/poets/balbir-rathi
Balraj Bakshi 	/poets/balraj-bakshi
Balraj Hayat 	/poets/balraj-hayat
Balraj Komal 	/poets/balraj-komal
Balwan Singh Azar 	/poets/balwan-singh-azar
Bano Bee 	/poets/bano-bee
Bano Tahira Sayeed 	/poets/bano-tahira-sayeed
Baqa Baluch 	/poets/baqa-baluch
Baqar Agah Vellori 	/poets/baqar-agah-vellori
Baqar Mehdi 	/poets/baqar-mehdi
Baqar Naqvi 	/poets/baqar-naqvi
Baqaullah 'Baqa' 	/poets/baqaullah-baqa
Baqi Ahmad Puri 	/poets/baqi-ahmad-puri
Baqi Siddiqui 	/poets/baqi-siddiqui
Barq Dehlvi 	/poets/barq-dehlvi
Barq Hyderabadi 	/poets/barq-hyderabadi
Bashar Nawaz 	/poets/bashar-nawaz
Basheer Ahmad Basheer 	/poets/basheer-ahmad-basheer
Basheer Ahmad Shad 	/poets/basheer-ahmad-shad
Basheer Dada 	/authors/basheer-dada
Basheer Munzir 	/poets/basheer-munzir
Basheeruddin Raaz 	/poets/basheeruddin-raaz
Basheer-un-Nisa Begum Barq 	/poets/basheer-un-nisa-begum-barq
Bashir Badr 	/poets/bashir-badr
Bashir Farooq 	/poets/bashir-farooq
Bashir Farooqi 	/poets/bashir-farooqi
Bashir Mehtaab 	/poets/bashir-mehtaab
Bashir Saifi 	/poets/bashir-saifi
Bashir Zaidi Aseer 	/poets/bashir-zaidi-aseer
Bashiruddin Ahmad Dehlvi 	/poets/bashiruddin-ahmad-dehlvi
Basir Sultan Kazmi 	/poets/basir-sultan-kazmi
Basit Bhopali 	/poets/basit-bhopali
Bayan Ahsanullah Khan 	/poets/bayan-ahsanullah-khan
Bayan Meeruti 	/poets/bayan-meeruti
Bayan Yazdani 	/poets/bayan-yazdani
Bebak  Bhojpuri 	/poets/bebak-bhojpuri
Bedam Shah Warsi 	/poets/bedam-shah-warsi
Bedar Sarmadi 	/poets/bedar-sarmadi
Bedil Haidri 	/poets/bedil-haidri
Beena goindi 	/poets/beena-goindi
Begam Lakhnavi 	/poets/begam-lakhnavi
Behzad Lakhnavi 	/poets/behzad-lakhnavi
Bekal Utsahi 	/poets/bekal-utsahi
Bekhud Badayuni 	/poets/bekhud-badayuni
Bekhud Dehlvi 	/poets/bekhud-dehlvi
Betab Azimabadi 	/poets/betab-azimabadi
Betab Lakhnavi 	/poets/betab-lakhnavi
Betab Sury 	/poets/betab-sury
Bharat Bhushan Pant 	/poets/bharat-bhushan-pant
Bhartendu Harishchandra 	/poets/bhartendu-harishchandra
Bhaskar Shukla 	/poets/bhaskar-shukla
Bhavesh Dilshad 	/poets/bhavesh-dilshad
Bhure Khan Ashufta 	/poets/bhure-khan-ashufta
Bilal Ahmad 	/poets/bilal-ahmad
Bilqees Khan 	/poets/bilqees-khan
Bilqis Zafirul Hasan 	/poets/bilqis-zafirul-hasan
Bilquis Begum 	/poets/bilquis-begum
Bimal Krishn Ashk 	/poets/bimal-krishn-ashk
Birj Lal Raana 	/poets/birj-lal-raana
Bishan Narayen Darabar 	/poets/bishan-narayen-darabar
Bismil Aghai 	/poets/bismil-aghai
Bismil Allahabadi 	/poets/bismil-allahabadi
Bismil Azimabadi 	/poets/bismil-azimabadi
Bismil Sabri 	/poets/bismil-sabri
Bismil Saeedi 	/poets/bismil-saeedi
Boom Merathi 	/poets/boom-merathi
Brahma Nand Jalees 	/poets/brahma-nand-jalees
Brijesh Ambar 	/poets/brijesh-ambar
Bubbles Hora Saba 	/poets/bubbles-hora-saba-3
Budh Parkash Gupta Jauhar Deobandi 	/poets/budh-parkash-gupta-jauhar-deobandi
Bushra Ejaz 	/poets/bushra-ejaz
Bushra Farrukh  	/poets/bushra-farrukh
Bushra Hashmi 	/poets/bushra-hashmi
Bushra Saeed 	/poets/bushra-saeed
Bushra Zaidi 	/poets/bushra-zaidi
Chakbast Brij Narayan 	/poets/chakbast-brij-narayan
Chaman Bhatnagar 	/poets/chaman-bhatnagar
Chaman Lal Chaman 	/poets/chaman-lal-chaman
Chand Akbarabadi 	/poets/chand-akbarabadi
Chandar Bhan Kaifi Delhwi 	/poets/chandar-bhan-kaifi-delhwi
Chandni Pandey 	/poets/chandni-pandey
Chandra Parkash Jauhar Bijnauri 	/poets/chandra-parkash-jauhar-bijnauri
Chandra Parkash Shad 	/poets/chandra-parkash-shad
Chandrabhan Khayal 	/poets/chandrabhan-khayal
Charagh Barelvi 	/poets/charagh-barelvi
Charan Singh Bashar 	/poets/charan-singh-bashar
Charkh Chinioti 	/poets/charkh-chinioti
Chaudhary Mohammad Naeem 	/poets/chaudhary-mohammad-naeem
Chiragh Hasan Hasrat 	/poets/chiragh-hasan-hasrat
Chitransh Khare 	/poets/chitransh-khare
Chakbast Brij Narayan 	/poets/chakbast-brij-narayan
Chaman Bhatnagar 	/poets/chaman-bhatnagar
Chaman Lal Chaman 	/poets/chaman-lal-chaman
Chand Akbarabadi 	/poets/chand-akbarabadi
Chandar Bhan Kaifi Delhwi 	/poets/chandar-bhan-kaifi-delhwi
Chandni Pandey 	/poets/chandni-pandey
Chandra Parkash Jauhar Bijnauri 	/poets/chandra-parkash-jauhar-bijnauri
Chandra Parkash Shad 	/poets/chandra-parkash-shad
Chandrabhan Khayal 	/poets/chandrabhan-khayal
Charagh Barelvi 	/poets/charagh-barelvi
Charan Singh Bashar 	/poets/charan-singh-bashar
Charkh Chinioti 	/poets/charkh-chinioti
Chaudhary Mohammad Naeem 	/poets/chaudhary-mohammad-naeem
Chiragh Hasan Hasrat 	/poets/chiragh-hasan-hasrat
Chitransh Khare 	/poets/chitransh-khare
D. Raj Kanwal 	/poets/d-raj-kanwal
Daem Gawwasi 	/poets/daem-gawwasi
Dagh Dehlvi 	/poets/dagh-dehlvi
Damodar Thakur Zaki 	/poets/damodar-thakur-zaki
Danish Aligarhi 	/poets/danish-aligarhi
Danish Farahi 	/poets/danish-farahi
Danish Farazi 	/poets/danish-farazi
Danish Nazeer Dani 	/poets/danish-nazeer-dani
Daniyal Tareer 	/poets/daniyal-tareer
Daood Mohsin 	/poets/daood-mohsin
Darshan Singh 	/poets/darshan-singh
darshika wasani 	/poets/darshika-wasani
darvesh bharti 	/poets/darvesh-bharti
Dattatriya Kaifi 	/poets/dattatriya-kaifi
Daud Aurangabadi 	/poets/daud-aurangabadi
Daud Ghazi 	/poets/daud-ghazi
Daur Afridi 	/poets/daur-afridi
Davarka Das Shola 	/poets/davarka-das-shola
Dawood Rizwan 	/poets/dawood-rizwan
Deed Rahi 	/poets/deed-rahi
Deepak Qamar 	/poets/deepak-qamar
Deepak Sharma Deep 	/poets/deepak-sharma-deep
Deepti Mishra 	/poets/deepti-mishra
Devesh Dixit 	/poets/devesh-dixit
Devmani pandey 	/poets/devmani-pandey
Dhanpat Rai Thapar Raz 	/poets/dhanpat-rai-thapar-raz
Dheerendra Singh Faiyaz 	/poets/dheerendra-singh-faiyaz
Dil Ayubi 	/poets/dil-ayubi
Dil Shahjahanpuri 	/poets/dil-shahjahanpuri
Dilawar Ali Aazar 	/poets/dilawar-ali-aazar
Dilawar Figar 	/poets/dilawar-figar
Dildar Hashmi 	/poets/dildar-hashmi
Dilkash Sagari 	/poets/dilkash-sagari
Dinakshi Sahar 	/poets/dinakshi-sahar
Dinesh Kumar 	/poets/dinesh-kumar
Dinesh naaidu 	/poets/dinesh-naaidu
Dinesh Thakur 	/poets/dinesh-thakur
Divakar Rahi 	/poets/divakar-rahi
divya maheshwari 	/poets/divya-maheshwari
Dr. Azam 	/poets/dr-azam
Dr. Mohammad Ali Johar 	/poets/dr-mohammad-ali-johar
Dr. Pinhaan 	/poets/dr-pinhaan
Dushyant Kumar 	/poets/dushyant-kumar
Dwijendra Dwij 	/poets/dwijendra-dwij
D. Raj Kanwal 	/poets/d-raj-kanwal
Daem Gawwasi 	/poets/daem-gawwasi
Dagh Dehlvi 	/poets/dagh-dehlvi
Damodar Thakur Zaki 	/poets/damodar-thakur-zaki
Danish Aligarhi 	/poets/danish-aligarhi
Danish Farahi 	/poets/danish-farahi
Danish Farazi 	/poets/danish-farazi
Danish Nazeer Dani 	/poets/danish-nazeer-dani
Daniyal Tareer 	/poets/daniyal-tareer
Daood Mohsin 	/poets/daood-mohsin
Darshan Singh 	/poets/darshan-singh
darshika wasani 	/poets/darshika-wasani
darvesh bharti 	/poets/darvesh-bharti
Dattatriya Kaifi 	/poets/dattatriya-kaifi
Daud Aurangabadi 	/poets/daud-aurangabadi
Daud Ghazi 	/poets/daud-ghazi
Daur Afridi 	/poets/daur-afridi
Davarka Das Shola 	/poets/davarka-das-shola
Dawood Rizwan 	/poets/dawood-rizwan
Deed Rahi 	/poets/deed-rahi
Deepak Qamar 	/poets/deepak-qamar
Deepak Sharma Deep 	/poets/deepak-sharma-deep
Deepti Mishra 	/poets/deepti-mishra
Devesh Dixit 	/poets/devesh-dixit
Devmani pandey 	/poets/devmani-pandey
Dhanpat Rai Thapar Raz 	/poets/dhanpat-rai-thapar-raz
Dheerendra Singh Faiyaz 	/poets/dheerendra-singh-faiyaz
Dil Ayubi 	/poets/dil-ayubi
Dil Shahjahanpuri 	/poets/dil-shahjahanpuri
Dilawar Ali Aazar 	/poets/dilawar-ali-aazar
Dilawar Figar 	/poets/dilawar-figar
Dildar Hashmi 	/poets/dildar-hashmi
Dilkash Sagari 	/poets/dilkash-sagari
Dinakshi Sahar 	/poets/dinakshi-sahar
Dinesh Kumar 	/poets/dinesh-kumar
Dinesh naaidu 	/poets/dinesh-naaidu
Dinesh Thakur 	/poets/dinesh-thakur
Divakar Rahi 	/poets/divakar-rahi
divya maheshwari 	/poets/divya-maheshwari
Dr. Azam 	/poets/dr-azam
Dr. Mohammad Ali Johar 	/poets/dr-mohammad-ali-johar
Dr. Pinhaan 	/poets/dr-pinhaan
Dushyant Kumar 	/poets/dushyant-kumar
Dwijendra Dwij 	/poets/dwijendra-dwij
Ehsan Akbar 	/poets/ehsan-akbar
Ehsan Ali Khan 	/poets/ehsan-ali-khan
Ehsan Asghar 	/poets/ehsan-asghar
Ehsan Danish 	/poets/ehsan-danish
Ehsan Darbhangavi 	/poets/ehsan-darbhangavi
Ehsan Jafri 	/poets/ehsan-jafri
Ehsan Saqib 	/poets/ehsan-saqib
Ehteram Islam 	/poets/ehteram-islam
Ehtimam Sadiq 	/poets/ehtimam-sadiq
Ehtisham Akhtar 	/poets/ehtisham-akhtar
Ehtisham Husain 	/poets/ehtisham-husain
Ehtisham ul Haq Siddiqui 	/poets/ehtisham-ul-haq-siddiqui
Ehya Bhojpuri 	/poets/ehya-bhojpuri
Ejaaz Ahamd Ejaaz 	/poets/ejaaz-ahamd-ejaaz
Ejaaz Talib 	/poets/ejaaz-talib
Ejaaz tawakkal 	/poets/ejaaz-tawakkal
Ejaz Asif 	/poets/ejaz-asif
Ejaz Azmi 	/poets/ejaz-azmi
Ejaz Farooqi 	/poets/ejaz-farooqi
Ejaz Gul 	/poets/ejaz-gul
Ejaz Obaid 	/poets/ejaz-obaid
Ejaz Rahi 	/poets/ejaz-rahi
Ejaz Rahmani 	/poets/ejaz-rahmani
Ejaz Rizvi 	/poets/ejaz-rizvi
Ejaz Siddiqi 	/poets/ejaz-siddiqi
Ejaz Warsi 	/poets/ejaz-warsi
Elizabeth Kurian Mona 	/poets/elizabeth-kurian-mona
Erum  Zehra 	/poets/erum-zehra
Etibar Sajid 	/poets/etibar-sajid
Ezaz Afzal 	/poets/ezaz-afzal
Ezaz Ahmad Azar 	/poets/ezaz-ahmad-azar
Ezaz Kazmi 	/poets/ezaz-kazmi
Ehsan Akbar 	/poets/ehsan-akbar
Ehsan Ali Khan 	/poets/ehsan-ali-khan
Ehsan Asghar 	/poets/ehsan-asghar
Ehsan Danish 	/poets/ehsan-danish
Ehsan Darbhangavi 	/poets/ehsan-darbhangavi
Ehsan Jafri 	/poets/ehsan-jafri
Ehsan Saqib 	/poets/ehsan-saqib
Ehteram Islam 	/poets/ehteram-islam
Ehtimam Sadiq 	/poets/ehtimam-sadiq
Ehtisham Akhtar 	/poets/ehtisham-akhtar
Ehtisham Husain 	/poets/ehtisham-husain
Ehtisham ul Haq Siddiqui 	/poets/ehtisham-ul-haq-siddiqui
Ehya Bhojpuri 	/poets/ehya-bhojpuri
Ejaaz Ahamd Ejaaz 	/poets/ejaaz-ahamd-ejaaz
Ejaaz Talib 	/poets/ejaaz-talib
Ejaaz tawakkal 	/poets/ejaaz-tawakkal
Ejaz Asif 	/poets/ejaz-asif
Ejaz Azmi 	/poets/ejaz-azmi
Ejaz Farooqi 	/poets/ejaz-farooqi
Ejaz Gul 	/poets/ejaz-gul
Ejaz Obaid 	/poets/ejaz-obaid
Ejaz Rahi 	/poets/ejaz-rahi
Ejaz Rahmani 	/poets/ejaz-rahmani
Ejaz Rizvi 	/poets/ejaz-rizvi
Ejaz Siddiqi 	/poets/ejaz-siddiqi
Ejaz Warsi 	/poets/ejaz-warsi
Elizabeth Kurian Mona 	/poets/elizabeth-kurian-mona
Erum  Zehra 	/poets/erum-zehra
Etibar Sajid 	/poets/etibar-sajid
Ezaz Afzal 	/poets/ezaz-afzal
Ezaz Ahmad Azar 	/poets/ezaz-ahmad-azar
Ezaz Kazmi 	/poets/ezaz-kazmi
Faez Dehlvi 	/poets/faez-dehlvi
Faheem Aazmi 	/poets/faheem-aazmi
Faheem Jogapuri 	/poets/faheem-jogapuri
Faheem Shanas Kazmi 	/poets/faheem-shanas-kazmi
Fahmi Badayuni 	/poets/fahmi-badayuni
Fahmida Riaz 	/poets/fahmida-riaz
Faisal Ajmi 	/poets/faisal-ajmi
Faisal Azeem 	/poets/faisal-azeem
Faisal Fehmi 	/poets/faisal-fehmi
Faisal Hashmi 	/poets/faisal-hashmi
Faisal Saeed Zirgham 	/poets/faisal-saeed-zirgham
Faiyaz Ahmad 	/poets/faiyaz-ahmad
FaIyaz Rashk 	/poets/faiyaz-rashk
Faiz Ahmad Faiz 	/poets/faiz-ahmad-faiz
Faiz Alam Babar 	/poets/faiz-alam-babar
faiz anwar 	/poets/faiz-anwar
Faiz Dakani 	/poets/faiz-dakani
faiz jaunpuri 	/poets/faiz-jaunpuri
Faiz Khalilabadi 	/poets/faiz-khalilabadi
Faiz ul Hasan 	/poets/faiz-ul-hasan
Faizan Arif 	/poets/faizan-arif
Faizan Hashmi 	/poets/faizan-hashmi
Faizi 	/poets/faizi
Faizi Nizam Puri 	/poets/faizi-nizam-puri
Faizi Sambalpuri 	/poets/faizi-sambalpuri
Fakhira batool 	/poets/fakhira-batool
Fakhr Abbas 	/poets/fakhr-abbas
Fakhr Zaman 	/poets/fakhr-zaman
Fakhr-e-Alam Nomani 	/poets/fakhr-e-alam-nomani
Fana bulandshahri 	/poets/fana-bulandshahri
Fana Nizami Kanpuri 	/poets/fana-nizami-kanpuri
Fani Badayuni 	/poets/fani-badayuni
Fani Jodhpuri 	/poets/fani-jodhpuri
Faqeeh Haidar 	/poets/faqeeh-haidar
Faragh Rohvi 	/poets/faragh-rohvi
Farah iqbal 	/poets/farah-iqbal
Farah Shahid 	/poets/farah-shahid
Farasat Rizwi 	/poets/farasat-rizwi
Faraz Mahmood Fariz 	/poets/faraz-mahmood-fariz
Faraz Sultanpuri 	/poets/faraz-sultanpuri
Fareed Ishrati 	/poets/fareed-ishrati
Fareed Javed 	/poets/fareed-javed
Fareed Parbati 	/poets/fareed-parbati
Farhan Salim 	/poets/farhan-salim
Farhat Abbas 	/poets/farhat-abbas
Farhat Abbas Shah 	/poets/farhat-abbas-shah
Farhat Ali Khan 	/poets/farhat-ali-khan
Farhat Ehsas 	/poets/farhat-ehsas
Farhat Kanpuri 	/poets/farhat-kanpuri
Farhat Nadeem Humayun 	/poets/farhat-nadeem-humayun
Faez Dehlvi 	/poets/faez-dehlvi
Faheem Aazmi 	/poets/faheem-aazmi
Faheem Jogapuri 	/poets/faheem-jogapuri
Faheem Shanas Kazmi 	/poets/faheem-shanas-kazmi
Fahmi Badayuni 	/poets/fahmi-badayuni
Fahmida Riaz 	/poets/fahmida-riaz
Faisal Ajmi 	/poets/faisal-ajmi
Faisal Azeem 	/poets/faisal-azeem
Faisal Fehmi 	/poets/faisal-fehmi
Faisal Hashmi 	/poets/faisal-hashmi
Faisal Saeed Zirgham 	/poets/faisal-saeed-zirgham
Faiyaz Ahmad 	/poets/faiyaz-ahmad
FaIyaz Rashk 	/poets/faiyaz-rashk
Faiz Ahmad Faiz 	/poets/faiz-ahmad-faiz
Faiz Alam Babar 	/poets/faiz-alam-babar
faiz anwar 	/poets/faiz-anwar
Faiz Dakani 	/poets/faiz-dakani
faiz jaunpuri 	/poets/faiz-jaunpuri
Faiz Khalilabadi 	/poets/faiz-khalilabadi
Faiz ul Hasan 	/poets/faiz-ul-hasan
Faizan Arif 	/poets/faizan-arif
Faizan Hashmi 	/poets/faizan-hashmi
Faizi 	/poets/faizi
Faizi Nizam Puri 	/poets/faizi-nizam-puri
Faizi Sambalpuri 	/poets/faizi-sambalpuri
Fakhira batool 	/poets/fakhira-batool
Fakhr Abbas 	/poets/fakhr-abbas
Fakhr Zaman 	/poets/fakhr-zaman
Fakhr-e-Alam Nomani 	/poets/fakhr-e-alam-nomani
Fana bulandshahri 	/poets/fana-bulandshahri
Fana Nizami Kanpuri 	/poets/fana-nizami-kanpuri
Fani Badayuni 	/poets/fani-badayuni
Fani Jodhpuri 	/poets/fani-jodhpuri
Faqeeh Haidar 	/poets/faqeeh-haidar
Faragh Rohvi 	/poets/faragh-rohvi
Farah iqbal 	/poets/farah-iqbal
Farah Shahid 	/poets/farah-shahid
Farasat Rizwi 	/poets/farasat-rizwi
Faraz Mahmood Fariz 	/poets/faraz-mahmood-fariz
Faraz Sultanpuri 	/poets/faraz-sultanpuri
Fareed Ishrati 	/poets/fareed-ishrati
Fareed Javed 	/poets/fareed-javed
Fareed Parbati 	/poets/fareed-parbati
Farhan Salim 	/poets/farhan-salim
Farhat Abbas 	/poets/farhat-abbas
Farhat Abbas Shah 	/poets/farhat-abbas-shah
Farhat Ali Khan 	/poets/farhat-ali-khan
Farhat Ehsas 	/poets/farhat-ehsas
Farhat Kanpuri 	/poets/farhat-kanpuri
Farhat Nadeem Humayun 	/poets/farhat-nadeem-humayun
Farhat Nadir Rizwi 	/poets/farhat-nadir-rizwi
Farhat Qadri 	/poets/farhat-qadri
Farhat Shahzad 	/poets/farhat-shahzad
Farhat Zahid 	/poets/farhat-zahid
Farigh Bukhari 	/poets/farigh-bukhari
Fariha Naqvi 	/poets/fariha-naqvi
Farkhanda Nasreen Hayat 	/poets/farkhanda-nasreen-hayat
Farogh Haiderabdi 	/poets/farogh-haiderabdi
Farooq Anjum 	/poets/farooq-anjum
Farooq Bakshi 	/poets/farooq-bakshi
Farooq Banspari 	/poets/farooq-banspari
Farooq Engineer 	/poets/farooq-engineer
Farooq muztar 	/poets/farooq-muztar
Farooq Nazki 	/poets/farooq-nazki
Farooq rahman 	/poets/farooq-rahman
Farooq Shafaq 	/poets/farooq-shafaq
Farooq Shamim 	/poets/farooq-shamim
Farrukh Jafari 	/poets/farrukh-jafari
Farrukh Yar 	/poets/farrukh-yar
Farrukh Zohra Gilani 	/poets/farrukh-zohra-gilani
Fartash Syed 	/poets/fartash-syed
Faryad Aazar 	/poets/faryad-aazar
Fasih Akmal 	/poets/fasih-akmal
Fasihullah Naqeeb 	/poets/fasihullah-naqeeb
Fatima Hasan 	/poets/fatima-hasan
Fatima wasia Jayasi 	/poets/fatima-wasia-jayasi
Fauq Ludhianvi 	/poets/fauq-ludhianvi
Fauziya rabab 	/poets/fauziya-rabab
Fawad Ahmad 	/poets/fawad-ahmad
Fay Seen Ejaz 	/poets/fay-seen-ejaz
Fayyaz Farooqi 	/poets/fayyaz-farooqi
Fayyaz Hashmi 	/poets/fayyaz-hashmi
Fayyaz tahseen 	/poets/fayyaz-tahseen
Fayyazudin Saib 	/poets/fayyazudin-saib
Faza Ibn e Faizi 	/poets/faza-ibn-e-faizi
Fazal Husain Sabir 	/poets/fazal-husain-sabir
Fazil Ansari 	/poets/fazil-ansari
Fazil Jamili 	/poets/fazil-jamili
Fazl Ahmad kariim Fazli 	/poets/fazl-ahmad-kariim-fazli
Fazl Tabish 	/poets/fazl-tabish
Fazlurrahman 	/poets/fazlurrahman
Feroze Natique Khusro 	/poets/feroze-natique-khusro
Fidvi Lahori 	/poets/fidvi-lahori
Figar Muradabadi 	/poets/figar-muradabadi
Figar Unnavi 	/poets/figar-unnavi
Firaq Gorakhpuri 	/poets/firaq-gorakhpuri
Firaq Jalalpuri 	/poets/firaq-jalalpuri
Firdaus Gayavi 	/poets/firdaus-gayavi
Fitrat Ansari 	/poets/fitrat-ansari
Fiza jalandharii 	/poets/fiza-jalandharii
Fiza Kausari 	/poets/fiza-kausari
France Gaudlib Queen Frasco 	/poets/france-gaudlib-queen-frasco
Furqat Kakorvi 	/poets/furqat-kakorvi
Fuzail Jafri 	/poets/fuzail-jafri
Gaffar Babar 	/poets/gaffar-babar
Ganesh Bihari Tarz 	/poets/ganesh-bihari-tarz
Gauhar Begum Gauhar 	/poets/gauhar-begum-gauhar
Gauhar Hoshiyarpuri 	/poets/gauhar-hoshiyarpuri
Gauhar Naushahi 	/poets/gauhar-naushahi
Gauhar Usmani 	/poets/gauhar-usmani
Gautam Rajrishi 	/poets/gautam-rajrishi
Gawwas Qureshi 	/poets/gawwas-qureshi
Geetanjali Rai 	/poets/geetanjali-rai
George Puech Shor 	/poets/george-puech-shor
Ghalib Ahmad 	/poets/ghalib-ahmad
Ghalib Ayaz 	/poets/ghalib-ayaz
Ghalib Irfan 	/poets/ghalib-irfan
Ghamgeen Dehlvi 	/poets/ghamgeen-dehlvi
Ghani Ejaz 	/poets/ghani-ejaz
Ghani Ghayoor 	/poets/ghani-ghayoor
Ghaus Khah makhah Hyderabadi 	/poets/ghaus-khah-makhah-hyderabadi
Ghaus Mohammad Ghausi 	/poets/ghaus-mohammad-ghausi
Ghaus Siwani 	/poets/ghaus-siwani
Ghausiya Khan Sabeen 	/poets/ghausiya-khan-sabeen
Ghayas Anjum 	/poets/ghayas-anjum
Ghayas Mateen 	/poets/ghayas-mateen
Ghazanfar 	/poets/ghazanfar
Ghazanfar Ali Ghazanfar 	/poets/ghazanfar-ali-ghazanfar
Ghazanfar Hashmi 	/poets/ghazanfar-hashmi
Ghous Mathravi 	/poets/ghous-mathravi
Ghubaar Bhatti 	/poets/ghubaar-bhatti
Ghufran Amjad 	/poets/ghufran-amjad
Ghulam Bhik Nairang 	/poets/ghulam-bhik-nairang
Ghulam Husain Ayaz 	/poets/ghulam-husain-ayaz
Ghulam Husain Sajid 	/poets/ghulam-husain-sajid
Ghulam Maula Qalaq 	/poets/ghulam-maula-qalaq
Ghulam Mohammad Qasir 	/poets/ghulam-mohammad-qasir
Ghulam Mohammad Safeer 	/poets/ghulam-mohammad-safeer
Ghulam Murtaza Rahi 	/poets/ghulam-murtaza-rahi
Ghulam Mustafa Faraz 	/poets/ghulam-mustafa-faraz
Ghzala Khakwani 	/poets/ghzala-khakwani
Ghzala Shahid 	/poets/ghzala-shahid
Girija Wiyas 	/poets/girija-wiyas
Gobind Parsad 	/poets/gobind-parsad
Gopal Krishna Shafaq 	/poets/gopal-krishna-shafaq
Gopal Mittal 	/poets/gopal-mittal
Gopaldas Neeraj 	/poets/gopaldas-neeraj
Gopi Nath Amn 	/poets/gopi-nath-amn
Gorbachan Singh Dayal Maghmum 	/poets/gorbachan-singh-dayal-maghmum
Govind Gulshan 	/poets/govind-gulshan
Goya Faqir Mohammad 	/poets/goya-faqir-mohammad
Guftar Khayali 	/poets/guftar-khayali
Guhar Khairabadi 	/poets/guhar-khairabadi
Gulam Dastgeer Mubeen 	/poets/gulam-dastgeer-mubeen
Gaffar Babar 	/poets/gaffar-babar
Ganesh Bihari Tarz 	/poets/ganesh-bihari-tarz
Gauhar Begum Gauhar 	/poets/gauhar-begum-gauhar
Gauhar Hoshiyarpuri 	/poets/gauhar-hoshiyarpuri
Gauhar Naushahi 	/poets/gauhar-naushahi
Gauhar Usmani 	/poets/gauhar-usmani
Gautam Rajrishi 	/poets/gautam-rajrishi
Gawwas Qureshi 	/poets/gawwas-qureshi
Geetanjali Rai 	/poets/geetanjali-rai
George Puech Shor 	/poets/george-puech-shor
Ghalib Ahmad 	/poets/ghalib-ahmad
Ghalib Ayaz 	/poets/ghalib-ayaz
Ghalib Irfan 	/poets/ghalib-irfan
Ghamgeen Dehlvi 	/poets/ghamgeen-dehlvi
Ghani Ejaz 	/poets/ghani-ejaz
Ghani Ghayoor 	/poets/ghani-ghayoor
Ghaus Khah makhah Hyderabadi 	/poets/ghaus-khah-makhah-hyderabadi
Ghaus Mohammad Ghausi 	/poets/ghaus-mohammad-ghausi
Ghaus Siwani 	/poets/ghaus-siwani
Ghausiya Khan Sabeen 	/poets/ghausiya-khan-sabeen
Ghayas Anjum 	/poets/ghayas-anjum
Ghayas Mateen 	/poets/ghayas-mateen
Ghazanfar 	/poets/ghazanfar
Ghazanfar Ali Ghazanfar 	/poets/ghazanfar-ali-ghazanfar
Ghazanfar Hashmi 	/poets/ghazanfar-hashmi
Ghous Mathravi 	/poets/ghous-mathravi
Ghubaar Bhatti 	/poets/ghubaar-bhatti
Ghufran Amjad 	/poets/ghufran-amjad
Ghulam Bhik Nairang 	/poets/ghulam-bhik-nairang
Ghulam Husain Ayaz 	/poets/ghulam-husain-ayaz
Ghulam Husain Sajid 	/poets/ghulam-husain-sajid
Ghulam Maula Qalaq 	/poets/ghulam-maula-qalaq
Ghulam Mohammad Qasir 	/poets/ghulam-mohammad-qasir
Ghulam Mohammad Safeer 	/poets/ghulam-mohammad-safeer
Ghulam Murtaza Rahi 	/poets/ghulam-murtaza-rahi
Ghulam Mustafa Faraz 	/poets/ghulam-mustafa-faraz
Ghzala Khakwani 	/poets/ghzala-khakwani
Ghzala Shahid 	/poets/ghzala-shahid
Girija Wiyas 	/poets/girija-wiyas
Gobind Parsad 	/poets/gobind-parsad
Gopal Krishna Shafaq 	/poets/gopal-krishna-shafaq
Gopal Mittal 	/poets/gopal-mittal
Gopaldas Neeraj 	/poets/gopaldas-neeraj
Gopi Nath Amn 	/poets/gopi-nath-amn
Gorbachan Singh Dayal Maghmum 	/poets/gorbachan-singh-dayal-maghmum
Govind Gulshan 	/poets/govind-gulshan
Goya Faqir Mohammad 	/poets/goya-faqir-mohammad
Guftar Khayali 	/poets/guftar-khayali
Guhar Khairabadi 	/poets/guhar-khairabadi
Gulam Dastgeer Mubeen 	/poets/gulam-dastgeer-mubeen
Gulam jilani Asghar 	/poets/gulam-jilani-asghar
Gulam Nabi Aawan 	/poets/gulam-nabi-aawan
Gulam Nabi Hakeem 	/poets/gulam-nabi-hakeem
Gulam Rasool Tariq 	/poets/gulam-rasool-tariq
Gulam Yahya Huzur Azimabadi 	/poets/gulam-yahya-huzur-azimabadi
Gulnar Aafreen 	/poets/gulnar-aafreen
Gulnaz Kausar 	/poets/gulnaz-kausar
Gulshan Barelvi 	/poets/gulshan-barelvi
gulshan-ud-daula Bahar 	/poets/gulshan-ud-daula-bahar
Gulzar 	/poets/gulzar
Gulzar Bukhari 	/poets/gulzar-bukhari
Gulzar Dehlvi 	/poets/gulzar-dehlvi
Gulzar Vafa Chaudari 	/poets/gulzar-vafa-chaudari
Gustakh Rampuri 	/poets/gustakh-rampuri
Gyan Chand 	/poets/gyan-chand
Gyan Chand Jain 	/poets/gyan-chand-jain
Gyan Chand Mansoor 	/poets/gyan-chand-mansoor
Habab Hashmi 	/poets/habab-hashmi
Habab Tirmizi 	/poets/habab-tirmizi
Habeeb Aarvi 	/poets/habeeb-aarvi
Habeeb Ahmad Siddiqui 	/poets/habeeb-ahmad-siddiqui
Habeeb Ashar Dehlavi 	/poets/habeeb-ashar-dehlavi
Habeeb Fakhri 	/poets/habeeb-fakhri
Habeeb Hyderabadi 	/poets/habeeb-hyderabadi
Habeeb Kaifi 	/poets/habeeb-kaifi
Habeeb Musvi 	/poets/habeeb-musvi
Habeeb Rahat Habab 	/poets/habeeb-rahat-habab
Habib Jalib 	/poets/habib-jalib
Habib Tanvir 	/poets/habib-tanvir
Hadi Machlishahri 	/poets/hadi-machlishahri
Hadis Salsal 	/poets/hadis-salsal
Hafeez Banarasi 	/poets/hafeez-banarasi
Hafeez Fatima Barelvi 	/poets/hafeez-fatima-barelvi
Hafeez Hoshiarpuri 	/poets/hafeez-hoshiarpuri
Hafeez Jalandhari 	/poets/hafeez-jalandhari
Hafeez Jaunpuri 	/poets/hafeez-jaunpuri
Hafeez Merathi 	/poets/hafeez-merathi
Hafiz Ahmad 	/poets/hafiz-ahmad
Hafiz Ludhiyanvi 	/poets/hafiz-ludhiyanvi
Hafiz Taib 	/poets/hafiz-taib
Haidar Ali Aatish 	/poets/haidar-ali-aatish
Haidar Ali Jafri 	/poets/haidar-ali-jafri
Haidar Qureshi 	/poets/haidar-qureshi
Hairat Allahabadi 	/poets/hairat-allahabadi
Hairat Gondvi 	/poets/hairat-gondvi
Hairat Saharvardi 	/poets/hairat-saharvardi
Hairat shimlavii 	/poets/hairat-shimlavii
Hakeem Asad Ali Khan muztar 	/poets/hakeem-asad-ali-khan-muztar
Hakeem Manzoor 	/poets/hakeem-manzoor
Hakeem Mohammad Husain Ahqar 	/poets/hakeem-mohammad-husain-ahqar
Hakeem Nasir 	/poets/hakeem-nasir
Hakeem Syed Mohammad Ghazipuri 	/poets/hakeem-syed-mohammad-ghazipuri
Hakim Mohammad Ajmal Khan Shaida 	/poets/hakim-mohammad-ajmal-khan-shaida
Haleem Qureshi 	/poets/haleem-qureshi
Hamdam Kashmiri 	/poets/hamdam-kashmiri
Hamdoon Usmani 	/poets/hamdoon-usmani
Hameed Almas 	/poets/hameed-almas-2
Hameed Gauhar 	/poets/hameed-gauhar
Hameed Jalandhari 	/poets/hameed-jalandhari
Hameed Jazib 	/poets/hameed-jazib
Hameed Kausar 	/poets/hameed-kausar
Hameed Nag Puri 	/poets/hameed-nag-puri
Hameed Naseem 	/poets/hameed-naseem-1
Hameed Naseem 	/poets/hameed-naseem
Hamid Allahabadi 	/poets/hamid-allahabadi
Hamid Husain Hamid 	/poets/hamid-husain-hamid
Hamid Iqbal Siddiqui 	/poets/hamid-iqbal-siddiqui
Habab Hashmi 	/poets/habab-hashmi
Habab Tirmizi 	/poets/habab-tirmizi
Habeeb Aarvi 	/poets/habeeb-aarvi
Habeeb Ahmad Siddiqui 	/poets/habeeb-ahmad-siddiqui
Habeeb Ashar Dehlavi 	/poets/habeeb-ashar-dehlavi
Habeeb Fakhri 	/poets/habeeb-fakhri
Habeeb Hyderabadi 	/poets/habeeb-hyderabadi
Habeeb Kaifi 	/poets/habeeb-kaifi
Habeeb Musvi 	/poets/habeeb-musvi
Habeeb Rahat Habab 	/poets/habeeb-rahat-habab
Habib Jalib 	/poets/habib-jalib
Habib Tanvir 	/poets/habib-tanvir
Hadi Machlishahri 	/poets/hadi-machlishahri
Hadis Salsal 	/poets/hadis-salsal
Hafeez Banarasi 	/poets/hafeez-banarasi
Hafeez Fatima Barelvi 	/poets/hafeez-fatima-barelvi
Hafeez Hoshiarpuri 	/poets/hafeez-hoshiarpuri
Hafeez Jalandhari 	/poets/hafeez-jalandhari
Hafeez Jaunpuri 	/poets/hafeez-jaunpuri
Hafeez Merathi 	/poets/hafeez-merathi
Hafiz Ahmad 	/poets/hafiz-ahmad
Hafiz Ludhiyanvi 	/poets/hafiz-ludhiyanvi
Hafiz Taib 	/poets/hafiz-taib
Haidar Ali Aatish 	/poets/haidar-ali-aatish
Haidar Ali Jafri 	/poets/haidar-ali-jafri
Haidar Qureshi 	/poets/haidar-qureshi
Hairat Allahabadi 	/poets/hairat-allahabadi
Hairat Gondvi 	/poets/hairat-gondvi
Hairat Saharvardi 	/poets/hairat-saharvardi
Hairat shimlavii 	/poets/hairat-shimlavii
Hakeem Asad Ali Khan muztar 	/poets/hakeem-asad-ali-khan-muztar
Hakeem Manzoor 	/poets/hakeem-manzoor
Hakeem Mohammad Husain Ahqar 	/poets/hakeem-mohammad-husain-ahqar
Hakeem Nasir 	/poets/hakeem-nasir
Hakeem Syed Mohammad Ghazipuri 	/poets/hakeem-syed-mohammad-ghazipuri
Hakim Mohammad Ajmal Khan Shaida 	/poets/hakim-mohammad-ajmal-khan-shaida
Haleem Qureshi 	/poets/haleem-qureshi
Hamdam Kashmiri 	/poets/hamdam-kashmiri
Hamdoon Usmani 	/poets/hamdoon-usmani
Hameed Almas 	/poets/hameed-almas-2
Hameed Gauhar 	/poets/hameed-gauhar
Hameed Jalandhari 	/poets/hameed-jalandhari
Hameed Jazib 	/poets/hameed-jazib
Hameed Kausar 	/poets/hameed-kausar
Hameed Nag Puri 	/poets/hameed-nag-puri
Hameed Naseem 	/poets/hameed-naseem-1
Hameed Naseem 	/poets/hameed-naseem
Hamid Allahabadi 	/poets/hamid-allahabadi
Hamid Husain Hamid 	/poets/hamid-husain-hamid
Hamid Iqbal Siddiqui 	/poets/hamid-iqbal-siddiqui
Hamid Jeelani 	/poets/hamid-jeelani
Hamid Kashmeeri 	/poets/hamid-kashmeeri
Hamid Mukhtar Hamid 	/poets/hamid-mukhtar-hamid
Hamid Saleem 	/poets/hamid-saleem
Hamid Sarosh 	/poets/hamid-sarosh
Hamid Yazdani 	/poets/hamid-yazdani
Hamid Zahoor  	/poets/hamid-zahoor
Hamida Shahin 	/poets/hamida-shahin
Hamidi Kashmiri 	/poets/hamidi-kashmiri
Hamidullah Afsar 	/poets/hamidullah-afsar
Hammad Niyazi 	/poets/hammad-niyazi
Haneef akhgar 	/poets/haneef-akhgar
Haneef Asadi 	/poets/haneef-asadi
Haneef Kaifi 	/poets/haneef-kaifi
Haneef Najmi 	/poets/haneef-najmi
Haneef Rahi 	/poets/haneef-rahi
Haneef Sajid 	/poets/haneef-sajid
Hanif Fauq 	/poets/hanif-fauq
Hanif Tarin 	/poets/hanif-tarin
Hans Raj Sachdev 'hazii.n' 	/poets/hans-raj-sachdev-haziin
Hanson Rehani 	/poets/hanson-rehani
Haqeer 	/poets/haqeer
Haqeer Jahani 	/poets/haqeer-jahani
Harbans Lal Aneja 'jamaal' 	/poets/harbans-lal-aneja-jamaal
Harbans Mukhia 	/poets/harbans-mukhia-1
Harbans Tasawwur 	/poets/harbans-tasawwur
Harbhajan Singh Sodhi Bismil 	/poets/harbhajan-singh-sodhi-bismil
Hari Chand Akhtar 	/poets/hari-chand-akhtar
Hari Mehta 	/poets/hari-mehta
Haris Bilal 	/poets/haris-bilal
Haris Khaleeq 	/poets/haris-khaleeq
Harsh Barham Bhat 	/poets/harsh-barham-bhat
Hasan Aabid 	/poets/hasan-aabid
Hasan Abbas Raza 	/poets/hasan-abbas-raza
Hasan Abbasi 	/poets/hasan-abbasi
Hasan Abidi 	/poets/hasan-abidi
Hasan Akbar Kamal 	/poets/hasan-akbar-kamal
Hasan Akhtar Jaleel 	/poets/hasan-akhtar-jaleel
Hasan Azimabadi 	/poets/hasan-azimabadi
Hasan Aziz 	/poets/hasan-aziz
Hasan Bakht 	/poets/hasan-bakht
Hasan Barelvi 	/poets/hasan-barelvi
Hasan Hameedi 	/poets/hasan-hameedi
Hasan Jameel 	/poets/hasan-jameel
Hasan Kamal 	/poets/hasan-kamal
Hasan Naim 	/poets/hasan-naim
Hasan Najmi Sikandarpuri 	/poets/hasan-najmi-sikandarpuri
Hasan Nasir 	/poets/hasan-nasir
Hasan Nizami 	/poets/hasan-nizami
Hasan Rizvi 	/poets/hasan-rizvi
Hasan Soz 	/poets/hasan-soz
Hasan Tahir 	/poets/hasan-tahir
Haseeb Rehbar 	/poets/haseeb-rehbar
Haseeb Soz 	/poets/haseeb-soz
Haseebul Hasan 	/poets/haseebul-hasan
Haseer Noori 	/poets/haseer-noori
Hashim Ali Khan Dilazak 	/poets/hashim-ali-khan-dilazak
Hashim Raza Jalalpuri 	/poets/hashim-raza-jalalpuri
Hasnain Aaqib 	/poets/hasnain-aaqib
Hasnain Jafri 	/poets/hasnain-jafri
Hasrat Azimabadi 	/poets/hasrat-azimabadi
Hasrat Deobandi 	/poets/hasrat-deobandi
Hasrat Jaipuri 	/poets/hasrat-jaipuri
Hasrat Kamali 	/poets/hasrat-kamali
Hasrat Mohani 	/poets/hasrat-mohani
Hasrat Sharvani 	/poets/hasrat-sharvani
Hassan Ahmad Awan 	/poets/hassan-ahmad-awan
Hastimal Hasti 	/poets/hastimal-hasti
Hatim Ali Mehr 	/poets/hatim-ali-mehar
Haya Lakhnavi 	/poets/haya-lakhnavi
Hayat Lakhnavi 	/poets/hayat-lakhnavi
Hayat Madrasi 	/poets/hayat-madrasi
Hayat Rizvi Amrohvi 	/poets/hayat-rizvi-amrohvi
Hayat Warsi 	/poets/hayat-warsi
Hazar Lakhnavi 	/poets/hazar-lakhnavi
Hazin Ludhianvi 	/poets/hazin-ludhianvi
Heera Lal Falak Dehlvi 	/poets/heera-lal-falak-dehlvi
Hidayatullah Khan Shamsi 	/poets/hidayatullah-khan-shamsi
Hijab Abbasi 	/poets/hijab-abbasi
Hijr Nazim Ali Khan 	/poets/hijr-nazim-ali-khan
Hilal Fareed 	/poets/hilal-fareed
Himayat Ali Shayar 	/poets/himayat-ali-shayar
Hina Rizwi 	/poets/hina-rizwi
Hina Taimuri 	/poets/hina-taimuri
hindii gorakhpurii 	/poets/hindii-gorakhpurii
Hira Nand Soz 	/poets/hira-nand-soz
Hosh Tirmizi 	/poets/hosh-tirmizi
Humaira Gul Tishna 	/poets/humaira-gul-tishna
Humaira Rahat 	/poets/humaira-rahat
Humaira Rahman 	/poets/humaira-rahman
Hurmatul Ikaram 	/poets/hurmatul-ikaram
Husain Abid 	/poets/husain-abid
Husain Majrooh 	/poets/husain-majrooh
Husain Sahar 	/poets/husain-sahar
Husain Taj Rizvi 	/poets/husain-taj-rizvi
Hussain Majid 	/poets/hussain-majid
Hussain meer Kashmiri 	/poets/hussain-meer-kashmiri
Ibn e Insha 	/poets/ibn-e-insha
Ibn-e-Mufti 	/poets/ibn-e-mufti
Ibn-e-Raza 	/poets/ibn-e-raza
Ibn-e-Safi 	/poets/ibn-e-safi
Ibn-e-Ummeed 	/poets/ibn-e-ummeed
Ibraheem Hosh 	/poets/ibraheem-hosh
Ibrahim Ashk 	/poets/ibrahim-ashk
Ibrat Bahraichi 	/poets/ibrat-bahraichi
Ibrat Machlishahri 	/poets/ibrat-machlishahri
Idris Babar 	/poets/idris-babar
Iffat abbas 	/poets/iffat-abbas
Iffat Zarrin 	/poets/iffat-zarrin
Iftikhar Aazmi 	/poets/iftikhar-aazmi
Iftikhar Ahmad Fakhr 	/poets/iftikhar-ahmad-fakhr
Iftikhar Arif 	/poets/iftikhar-arif
Iftikhar Bukhari 	/poets/iftikhar-bukhari
Iftikhar Falak Kazmi 	/poets/iftikhar-falak-kazmi
Iftikhar Husain Rizwi Saeed 	/poets/iftikhar-husain-rizwi-saeed
Iftikhar Imam Siddiqi 	/poets/iftikhar-imam-siddiqi
Iftikhar Jalib 	/poets/iftikhar-jalib
Iftikhar Jameel Shaheen 	/poets/iftikhar-jameel-shaheen
Iftikhar Mughal 	/poets/iftikhar-mughal
Iftikhar Naseem 	/poets/iftikhar-naseem
Iftikhar Qaisar 	/poets/iftikhar-qaisar
Iftikhar Raghib 	/poets/iftikhar-raghib
Iftikhar Shafi 	/poets/iftikhar-shafi
Ijtiba Rizvi 	/poets/ijtiba-rizvi
Ikram Azam 	/poets/ikram-azam
Ikram Janjua 	/poets/ikram-janjua
Ikram Mujeeb 	/poets/ikram-mujeeb
Ikram Tabassum 	/poets/ikram-tabassum
Iliyas Babar Aawan 	/poets/iliyas-babar-aawan
Ilyas Ishqi 	/poets/ilyas-ishqi
Imam Azam 	/poets/imam-azam
Imam Bakhsh Nasikh 	/poets/imam-bakhsh-nasikh
Imdad Akash 	/poets/imdad-akash
Imdad Ali Bahr 	/poets/shaikh-imdad-ali-bahr-lakhnavi
Imdad Hamdani 	/poets/imdad-hamdani
Imdad Imam Asar 	/poets/imdad-imam-asar
Imdad Nizaamii 	/poets/imdad-nizaamii
Imran Aami 	/poets/imran-aami
Imran Husain Azad 	/poets/imran-husain-azad
Imran Saghar 	/poets/imran-saghar
Imran Shamshad 	/poets/imran-shamshad
Imran Shanawar 	/poets/imran-shanawar
Imran-ul-haq Chauhan 	/poets/imran-ul-haq-chauhan
Imtiyaz Ahmad Rahi 	/poets/imtiyaz-ahmad-rahi
Imtiyaz Ali Gauhar 	/poets/imtiyaz-ali-gauhar
imtiyaz Khan 	/poets/imtiyaz-khan
Imtiyaz Saghar 	/poets/imtiyaz-saghar
Ibn e Insha 	/poets/ibn-e-insha
Ibn-e-Mufti 	/poets/ibn-e-mufti
Ibn-e-Raza 	/poets/ibn-e-raza
Ibn-e-Safi 	/poets/ibn-e-safi
Ibn-e-Ummeed 	/poets/ibn-e-ummeed
Ibraheem Hosh 	/poets/ibraheem-hosh
Ibrahim Ashk 	/poets/ibrahim-ashk
Ibrat Bahraichi 	/poets/ibrat-bahraichi
Ibrat Machlishahri 	/poets/ibrat-machlishahri
Idris Babar 	/poets/idris-babar
Iffat abbas 	/poets/iffat-abbas
Iffat Zarrin 	/poets/iffat-zarrin
Iftikhar Aazmi 	/poets/iftikhar-aazmi
Iftikhar Ahmad Fakhr 	/poets/iftikhar-ahmad-fakhr
Iftikhar Arif 	/poets/iftikhar-arif
Iftikhar Bukhari 	/poets/iftikhar-bukhari
Iftikhar Falak Kazmi 	/poets/iftikhar-falak-kazmi
Iftikhar Husain Rizwi Saeed 	/poets/iftikhar-husain-rizwi-saeed
Iftikhar Imam Siddiqi 	/poets/iftikhar-imam-siddiqi
Iftikhar Jalib 	/poets/iftikhar-jalib
Iftikhar Jameel Shaheen 	/poets/iftikhar-jameel-shaheen
Iftikhar Mughal 	/poets/iftikhar-mughal
Iftikhar Naseem 	/poets/iftikhar-naseem
Iftikhar Qaisar 	/poets/iftikhar-qaisar
Iftikhar Raghib 	/poets/iftikhar-raghib
Iftikhar Shafi 	/poets/iftikhar-shafi
Ijtiba Rizvi 	/poets/ijtiba-rizvi
Ikram Azam 	/poets/ikram-azam
Ikram Janjua 	/poets/ikram-janjua
Ikram Mujeeb 	/poets/ikram-mujeeb
Ikram Tabassum 	/poets/ikram-tabassum
Iliyas Babar Aawan 	/poets/iliyas-babar-aawan
Ilyas Ishqi 	/poets/ilyas-ishqi
Imam Azam 	/poets/imam-azam
Imam Bakhsh Nasikh 	/poets/imam-bakhsh-nasikh
Imdad Akash 	/poets/imdad-akash
Imdad Ali Bahr 	/poets/shaikh-imdad-ali-bahr-lakhnavi
Imdad Hamdani 	/poets/imdad-hamdani
Imdad Imam Asar 	/poets/imdad-imam-asar
Imdad Nizaamii 	/poets/imdad-nizaamii
Imran Aami 	/poets/imran-aami
Imran Husain Azad 	/poets/imran-husain-azad
Imran Saghar 	/poets/imran-saghar
Imran Shamshad 	/poets/imran-shamshad
Imran Shanawar 	/poets/imran-shanawar
Imran-ul-haq Chauhan 	/poets/imran-ul-haq-chauhan
Imtiyaz Ahmad Rahi 	/poets/imtiyaz-ahmad-rahi
Imtiyaz Ali Gauhar 	/poets/imtiyaz-ali-gauhar
imtiyaz Khan 	/poets/imtiyaz-khan
Imtiyaz Saghar 	/poets/imtiyaz-saghar
Imtiyaz-ul-haq Imtiyaz 	/poets/imtiyaz-ul-haq-imtiyaz
inaam azmi 	/poets/inaam-azmi
inaam Hanafi 	/poets/inaam-hanafi
Inam Durrani 	/poets/inam-durrani
Inam Kabeer 	/poets/inam-kabeer
Inam Nadeem 	/poets/inam-nadeem
Inam-ul-Haq Javed 	/poets/inam-ul-haq-javed
Inder Saraazi 	/poets/inder-saraazi
Indira Varma 	/poets/indira-varma
Indr Mohan Mehta Kaif 	/poets/indr-mohan-mehta-kaif
Indr Swarup Srivastava 	/poets/indr-swarup-srivastava
Injeel Saheefa 	/poets/injeel-saheefa
Injila Hamesh 	/poets/injila-hamesh
Insha Allah Khan 'Insha' 	/poets/insha-allah-khan-insha
Intesar Husain Abidi Shahid 	/poets/intesar-husain-abidi-shahid
Intikhab Alam 	/poets/intikhab-alam
Intikhab Syed 	/poets/intikhab-syed
Intizar Ghazipuri 	/poets/intizar-ghazipuri
Iqbal Abidi 	/poets/iqbal-abidi
Iqbal Anjum 	/poets/iqbal-anjum
Iqbal Ashhar 	/poets/iqbal-ashhar
Iqbal Ashhar Qureshi 	/poets/iqbal-ashhar-qureshi
Iqbal Asif 	/poets/iqbal-asif
Iqbal Azeem 	/poets/iqbal-azeem
Iqbal Haider 	/poets/iqbal-haider
Iqbal Haidri 	/poets/iqbal-haidri
Iqbal Husain Rizvi Iqbal 	/poets/iqbal-husain-rizvi-iqbal
Iqbal Kaifi 	/poets/iqbal-kaifi
Iqbal Kausar 	/poets/iqbal-kausar
Iqbal Khusro Qadri 	/poets/iqbal-khusro-qadri
Iqbal Mahir 	/poets/iqbal-mahir
Iqbal Mateen 	/poets/iqbal-mateen
Iqbal Minhas 	/poets/iqbal-minhas
Iqbal Naazir 	/poets/iqbal-naazir
Iqbal Naved 	/poets/iqbal-naved
Iqbal Payam 	/poets/iqbal-payam
Iqbal Safi Puri 	/poets/iqbal-safi-puri
Iqbal Sajid 	/poets/iqbal-sajid
Iqbal Suhail 	/poets/iqbal-suhail
Iqbal Umar 	/poets/iqbal-umar
Iqra Afiya  new	/poets/iqra-afiya
Iqtidar Javed 	/poets/iqtidar-javed
Iram Lakhnavi 	/poets/iram-lakhnavi
Irfan Ahmad 	/poets/irfan-ahmad
Irfan Ahmad mir 	/poets/irfan-ahmad-mir
Irfan Parbhanvi 	/poets/irfan-parbhanvi
Irfan Sattar 	/poets/irfan-sattar
Irfan Siddiqi 	/poets/irfan-siddiqi
Irfan Waheed 	/poets/irfan-waheed
Irfana Azeez 	/poets/irfana-azeez
Irfanullah Irfan 	/poets/irfanullah-irfan
Irshad Arshii 	/poets/irshad-arshii
Irshad Husain Kazmi 	/poets/irshad-husain-kazmi
Irshad Kamil 	/poets/irshad-kamil
Irshad Khan ’Sikandar’ 	/poets/irshad-khan-sikandar
Irshad Shaikh 	/poets/irshad-shaikh
Irtiza Nishat 	/poets/irtiza-nishat
Is.haq Zafar 	/poets/ishaq-zafar
Ishaq Athar Siddiqui 	/poets/ishaq-athar-siddiqui
Ishaq Virdag 	/poets/ishaq-virdag
Ishq Aurangabadi 	/poets/ishq-aurangabadi
Ishq Azimabadi 	/poets/ishq-azimabadi
Ishraque Azizi 	/poets/ishraque-azizi
Ishrat Afreen 	/poets/ishrat-afreen
Ishrat Anwar 	/poets/ishrat-anwar
Ishrat Kiratpuri 	/poets/ishrat-kiratpuri
Ishrat Qadri 	/poets/ishrat-qadri
Ishrat Rumani 	/poets/ishrat-rumani
Ishrat Zafar 	/poets/ishrat-zafar
Ishtiyaq Talib 	/poets/ishtiyaq-talib
Islam Uzma 	/poets/islam-uzma
Ismail Merathi 	/poets/ismail-merathi
Izhaar Malihabadi 	/poets/izhaar-malihabadi
Izhar Asar 	/poets/izhar-asar
Izhar Warsi 	/poets/izhar-warsi
J. P. Saeed 	/poets/j-p-saeed
Jaan Nisar Akhtar 	/poets/jaan-nisar-akhtar
jaanaan malik 	/poets/jaanaan-malik
Jabbar Jameel  	/poets/jabbar-jameel
Jafar Abbas 	/poets/jafar-abbas
Jafar Abbas Safvi 	/poets/jafar-abbas-safvi
Jafar Ali Hasrat 	/poets/jafar-ali-hasrat
Jafar Baluch 	/poets/jafar-baluch
Jafar Raza 	/authors/jafar-raza
Jafar Sahni 	/poets/jafar-sahni
Jafar Shirazi 	/poets/jafar-shirazi
Jafar Tahir 	/poets/jafar-tahir
Jagan Nath Azad 	/poets/jagan-nath-azad
Jagat Mohan Lal Ravan 	/poets/jagat-mohan-lal-ravan
Jagdeesh Parkash 	/poets/jagdeesh-parkash
Jagdeesh Raj Figar 	/poets/jagdeesh-raj-figar
Jagdish Sahay Saxena 	/poets/jagdish-sahay-saxena
Jahangeer Imran 	/poets/jahangeer-imran
Jahangeer nayab 	/poets/jahangeer-nayab
Jaimini Sarshar 	/poets/jaimini-sarshar
Jalal Lakhnavi 	/poets/jalal-lakhnavi
Jalaluddin Akbar 	/poets/jalaluddin-akbar
Jalee Amrohvi 	/poets/jalee-amrohvi
Jaleel 'Aali' 	/poets/jaleel-aali
Jaleel Allahabadi 	/poets/jaleel-allahabadi
Jaleel Fatehpuri 	/poets/jaleel-fatehpuri
Jaleel Haider Lashari 	/poets/jaleel-haider-lashari
Jaleel Hashmi 	/poets/jaleel-hashmi
Jaleel Manikpuri 	/poets/jaleel-manikpuri
Jaleel Qidwai 	/poets/jaleel-qidwai
Jaleel Saz 	/poets/jaleel-saz
Jaleel Sherkoti 	/poets/jaleel-sherkoti
Jalib Nomani 	/poets/jalib-nomani
Jamal Ehsani 	/poets/jamal-ehsani
Jamal Owaisi 	/poets/jamal-owaisi
Jamal Panipati 	/poets/jamal-panipati
Jameel Azimabadi 	/poets/jameel-azimabadi
Jameel Hamdam 	/poets/jameel-hamdam
Jameel Malik 	/poets/jameel-malik
Jameel Mazhari 	/poets/jameel-mazhari
Jameel Qureshi 	/poets/jameel-qureshi
Jameel ur Rahman 	/poets/jameel-ur-rahman
Jameel Usman 	/poets/jameel-usman
Jameel Yusuf 	/poets/jameel-yusuf
Jameela Khatoon Tasneem 	/poets/jameela-khatoon-tasneem
Jameela Khuda Bakhsh 	/poets/jameela-khuda-bakhsh
Jameeluddin Aali 	/poets/jameeluddin-aali
Jameeluddin Qadri 	/poets/jameeluddin-qadri
Jami Rudaulvi 	/poets/jami-rudaulvi
Jamil Nazar 	/poets/jamil-nazar
J. P. Saeed 	/poets/j-p-saeed
Jaan Nisar Akhtar 	/poets/jaan-nisar-akhtar
jaanaan malik 	/poets/jaanaan-malik
Jabbar Jameel  	/poets/jabbar-jameel
Jafar Abbas 	/poets/jafar-abbas
Jafar Abbas Safvi 	/poets/jafar-abbas-safvi
Jafar Ali Hasrat 	/poets/jafar-ali-hasrat
Jafar Baluch 	/poets/jafar-baluch
Jafar Raza 	/authors/jafar-raza
Jafar Sahni 	/poets/jafar-sahni
Jafar Shirazi 	/poets/jafar-shirazi
Jafar Tahir 	/poets/jafar-tahir
Jagan Nath Azad 	/poets/jagan-nath-azad
Jagat Mohan Lal Ravan 	/poets/jagat-mohan-lal-ravan
Jagdeesh Parkash 	/poets/jagdeesh-parkash
Jagdeesh Raj Figar 	/poets/jagdeesh-raj-figar
Jagdish Sahay Saxena 	/poets/jagdish-sahay-saxena
Jahangeer Imran 	/poets/jahangeer-imran
Jahangeer nayab 	/poets/jahangeer-nayab
Jaimini Sarshar 	/poets/jaimini-sarshar
Jalal Lakhnavi 	/poets/jalal-lakhnavi
Jalaluddin Akbar 	/poets/jalaluddin-akbar
Jalee Amrohvi 	/poets/jalee-amrohvi
Jaleel 'Aali' 	/poets/jaleel-aali
Jaleel Allahabadi 	/poets/jaleel-allahabadi
Jaleel Fatehpuri 	/poets/jaleel-fatehpuri
Jaleel Haider Lashari 	/poets/jaleel-haider-lashari
Jaleel Hashmi 	/poets/jaleel-hashmi
Jaleel Manikpuri 	/poets/jaleel-manikpuri
Jaleel Qidwai 	/poets/jaleel-qidwai
Jaleel Saz 	/poets/jaleel-saz
Jaleel Sherkoti 	/poets/jaleel-sherkoti
Jalib Nomani 	/poets/jalib-nomani
Jamal Ehsani 	/poets/jamal-ehsani
Jamal Owaisi 	/poets/jamal-owaisi
Jamal Panipati 	/poets/jamal-panipati
Jameel Azimabadi 	/poets/jameel-azimabadi
Jameel Hamdam 	/poets/jameel-hamdam
Jameel Malik 	/poets/jameel-malik
Jameel Mazhari 	/poets/jameel-mazhari
Jameel Qureshi 	/poets/jameel-qureshi
Jameel ur Rahman 	/poets/jameel-ur-rahman
Jameel Usman 	/poets/jameel-usman
Jameel Yusuf 	/poets/jameel-yusuf
Jameela Khatoon Tasneem 	/poets/jameela-khatoon-tasneem
Jameela Khuda Bakhsh 	/poets/jameela-khuda-bakhsh
Jameeluddin Aali 	/poets/jameeluddin-aali
Jameeluddin Qadri 	/poets/jameeluddin-qadri
Jami Rudaulvi 	/poets/jami-rudaulvi
Jamil Nazar 	/poets/jamil-nazar
Jamill Murassapuri 	/poets/jamill-murassapuri
Jamshed Afaq 	/poets/jamshed-afaq
Jamshed Masroor 	/poets/jamshed-masroor
Jamuna Parsad Rahi 	/poets/jamuna-parsad-rahi
Jan Kashmiri 	/poets/jan-kashmiri
Jarrar Chhaulisi 	/poets/jarrar-chhaulisi
Jatinder Parwaaz 	/poets/jatinder-parwaaz
Jatinder Vir Yakhmi 'jayaveer' 	/poets/jatinder-vir-yakhmi-jayaveer
Jauhar meer 	/poets/jauhar-meer
Jauhar Nizami 	/poets/jauhar-nizami
Jauhar Siwani 	/poets/jauhar-siwani
Jauhar Zahiri 	/poets/jauhar-zahiri
Jaun Eliya 	/poets/jaun-eliya
Javaid Anwar 	/poets/javaid-anwar
Javed Ahmad 	/poets/javed-ahmad
Javed Akhtar 	/poets/javed-akhtar
Javed Akram Farooqi 	/poets/javed-akram-farooqi
Javed Jameel 	/poets/javed-jameel
Javed Kamal Rampuri 	/poets/javed-kamal-rampuri
Javed Lahori 	/poets/javed-lahori
Javed Lakhnvi 	/poets/javed-lakhnvi
Javed Nadeem 	/poets/javed-nadeem
Javed Naseemi 	/poets/javed-naseemi
Javed Nasir 	/poets/javed-nasir
Javed Quraishi 	/poets/javed-quraishi
Javed Saba 	/poets/javed-saba
Javed Shaheen 	/poets/javed-shaheen
Javed Siddiqi Azmi 	/poets/javed-siddiqi-azmi
Javed Vashisht 	/poets/javed-vashisht
Jawad Sheikh 	/poets/jawad-sheikh
Jawaz Jafri 	/poets/jawaz-jafri
Jawed Manzar 	/poets/jawed-manzar-1
Jayant Parmar 	/poets/jayant-parmar
Jazib Quraishi 	/poets/jazib-quraishi
Jeem Jazil 	/poets/jeem-jazil
Jigar Barelvi 	/poets/jigar-barelvi
Jigar Biswani 	/poets/jigar-biswani
Jigar Jalandhari 	/poets/jigar-jalandhari
Jigar Moradabadi 	/poets/jigar-moradabadi
Jilani Kamran 	/poets/jilani-kamran
Jitendra Mohan Sinha Rahbar 	/poets/jitendra-mohan-sinha-rahbar
Josh Malihabadi 	/poets/josh-malihabadi
Josh Malsiani 	/poets/josh-malsiani
Joshish Azimabadi 	/poets/joshish-azimabadi
Julius Naheef Dehlvi 	/poets/julius-naheef-dehlvi
Jumbish Khairabadi 	/poets/jumbish-khairabadi
Junaid Akhtar 	/poets/junaid-akhtar
Junaid Hazin Lari 	/poets/junaid-hazin-lari
Jurat Qalandar Bakhsh 	/poets/jurat-qalandar-bakhsh
Jurm Mohammadabadi 	/poets/jurm-mohammadabadi
Jyoti Azad Khatri 	/poets/jyoti-azad-khatri
Kaami Shah 	/poets/kaami-shah
Kabeer Athar 	/poets/kabeer-athar
Kabir Ajmal 	/poets/kabir-ajmal
Kafeel Aazar Amrohvi 	/poets/kafeel-aazar-amrohvi
Kaif Ahmed Siddiqui 	/poets/kaif-ahmed-siddiqui
Kaif Ansari 	/poets/kaif-ansari
Kaif Azimabadi 	/poets/kaif-azimabadi
Kaif Bhopali 	/poets/kaif-bhopali
Kaif Ikrami 	/poets/kaif-ikrami
Kaifi Azmi 	/poets/kaifi-azmi
Kaifi Hyderabadi 	/poets/kaifi-hyderabadi
Kaifi Wijdani 	/poets/kaifi-wijdani
Kailash Mahir 	/poets/kailash-mahir
Kaleem Aajiz 	/poets/kaleem-aajiz
Kaleem Ahmadabadi 	/poets/kaleem-ahmadabadi
Kaleem Haider Sharar 	/poets/kaleem-haider-sharar
Kaleem Sahasrami 	/poets/kaleem-sahasrami
Kaleem Usmani 	/poets/kaleem-usmani
Kalidas Gupta Raza 	/poets/kalidas-gupta-raza
Kalim Akhtar 	/poets/kalim-akhtar
Kamal Ahmad Siddiqi 	/poets/kamal-ahmad-siddiqi
Kamal Jafari 	/poets/kamal-jafari
Kamal Upadhyay 	/poets/kamal-upadhyay
Kamil Akhtar 	/poets/kamil-akhtar
Kamil Bahzadi 	/poets/kamil-bahzadi
Kamran Adil 	/poets/kamran-adil
Kamran Ghani Saba 	/poets/kamran-ghani-saba
Kamran Nadeem 	/poets/kamran-nadeem
Kanti Mohan Soz 	/poets/kanti-mohan-soz
kanval Dibaivi 	/poets/kanval-dibaivi
Kanval M.A 	/poets/kanval-ma
Kanval Ziai 	/poets/kanval-ziai
Kanwal Feroz 	/poets/kanwal-feroz
Kanwal Siyalkoti 	/poets/kanwal-siyalkoti
Karam Haidari 	/poets/karam-haidari
Karam Hyderabadi 	/poets/karam-hyderabadi
Karamat Ali Karamat 	/poets/karamat-ali-karamat
Karamat Ali Shaheedi 	/poets/karamat-ali-shaheedi
Karamat Bukhari 	/poets/karamat-bukhari
Karan Singh Karan 	/poets/karan-singh-karan
Karimuddin Sanat Moradabadi 	/poets/karimuddin-sanat-moradabadi
Karrar noori 	/poets/karrar-noori
Kashfi Lucknavi 	/poets/kashfi-lucknavi
Kashfi Multani 	/poets/kashfi-multani
Kashif Husain Ghair 	/poets/kashif-husain-ghair
Kashif Majeed 	/poets/kashif-majeed
Kashif Rafiq 	/poets/kashif-rafiq
Kashmiri Lal Zakir 	/poets/kashmiri-lal-zakir
Kaukab Shahjahanpuri 	/poets/kaukab-shahjahanpuri
Kausar Jayasi 	/poets/kausar-jayasi
Kaami Shah 	/poets/kaami-shah
Kabeer Athar 	/poets/kabeer-athar
Kabir Ajmal 	/poets/kabir-ajmal
Kafeel Aazar Amrohvi 	/poets/kafeel-aazar-amrohvi
Kaif Ahmed Siddiqui 	/poets/kaif-ahmed-siddiqui
Kaif Ansari 	/poets/kaif-ansari
Kaif Azimabadi 	/poets/kaif-azimabadi
Kaif Bhopali 	/poets/kaif-bhopali
Kaif Ikrami 	/poets/kaif-ikrami
Kaifi Azmi 	/poets/kaifi-azmi
Kaifi Hyderabadi 	/poets/kaifi-hyderabadi
Kaifi Wijdani 	/poets/kaifi-wijdani
Kailash Mahir 	/poets/kailash-mahir
Kaleem Aajiz 	/poets/kaleem-aajiz
Kaleem Ahmadabadi 	/poets/kaleem-ahmadabadi
Kaleem Haider Sharar 	/poets/kaleem-haider-sharar
Kaleem Sahasrami 	/poets/kaleem-sahasrami
Kaleem Usmani 	/poets/kaleem-usmani
Kalidas Gupta Raza 	/poets/kalidas-gupta-raza
Kalim Akhtar 	/poets/kalim-akhtar
Kamal Ahmad Siddiqi 	/poets/kamal-ahmad-siddiqi
Kamal Jafari 	/poets/kamal-jafari
Kamal Upadhyay 	/poets/kamal-upadhyay
Kamil Akhtar 	/poets/kamil-akhtar
Kamil Bahzadi 	/poets/kamil-bahzadi
Kamran Adil 	/poets/kamran-adil
Kamran Ghani Saba 	/poets/kamran-ghani-saba
Kamran Nadeem 	/poets/kamran-nadeem
Kanti Mohan Soz 	/poets/kanti-mohan-soz
kanval Dibaivi 	/poets/kanval-dibaivi
Kanval M.A 	/poets/kanval-ma
Kanval Ziai 	/poets/kanval-ziai
Kanwal Feroz 	/poets/kanwal-feroz
Kanwal Siyalkoti 	/poets/kanwal-siyalkoti
Karam Haidari 	/poets/karam-haidari
Karam Hyderabadi 	/poets/karam-hyderabadi
Karamat Ali Karamat 	/poets/karamat-ali-karamat
Karamat Ali Shaheedi 	/poets/karamat-ali-shaheedi
Karamat Bukhari 	/poets/karamat-bukhari
Karan Singh Karan 	/poets/karan-singh-karan
Karimuddin Sanat Moradabadi 	/poets/karimuddin-sanat-moradabadi
Karrar noori 	/poets/karrar-noori
Kashfi Lucknavi 	/poets/kashfi-lucknavi
Kashfi Multani 	/poets/kashfi-multani
Kashif Husain Ghair 	/poets/kashif-husain-ghair
Kashif Majeed 	/poets/kashif-majeed
Kashif Rafiq 	/poets/kashif-rafiq
Kashmiri Lal Zakir 	/poets/kashmiri-lal-zakir
Kaukab Shahjahanpuri 	/poets/kaukab-shahjahanpuri
Kausar Jayasi 	/poets/kausar-jayasi
Kausar Mahmood 	/poets/kausar-mahmood
Kausar Mazhari 	/poets/kausar-mazhari
Kausar Niyazi 	/poets/kausar-niyazi
Kausar Siwani 	/poets/kausar-siwani
Kavish Badri 	/poets/kavish-badri
Kavish Bat 	/poets/kavish-bat
Kavita Kiran 	/poets/kavita-kiran
Kazim Husain Kazim 	/poets/kazim-husain-kazim
Kewal Krishan Rishi 	/poets/kewal-krishan-rishi
Khaavar Ejaz 	/poets/khaavar-ejaz
Khaavar Jilani 	/poets/khaavar-jilani
Khadija Khan 	/poets/khadija-khan
Khadim Razmi 	/poets/khadim-razmi
Khaleel Afraz 	/poets/khaleel-afraz
Khaleel Mamoon 	/poets/khaleel-mamoon
Khaleel Raazi 	/poets/khaleel-raazi
Khaleel Rampuri 	/poets/khaleel-rampuri
Khaleel Tanveer 	/poets/khaleel-tanveer
Khaleeq Qureshi 	/poets/khaleeq-qureshi
Khaleeq Siddiqui 	/poets/khaleeq-siddiqui
Khalid Ahmad 	/poets/khalid-ahmad
Khalid Alig 	/poets/khalid-alig
Khalid Ebadi 	/poets/khalid-ebadi
Khalid Fatehpuri 	/poets/khalid-fatehpuri
Khalid Ghani 	/poets/khalid-ghani
Khalid Hasan Qadiri 	/poets/khalid-hasan-qadiri
Khalid Iqbal Taib 	/poets/khalid-iqbal-taib
Khalid Iqbal Yasir 	/poets/khalid-iqbal-yasir
Khalid Irfan 	/poets/khalid-irfan
Khalid Jamal 	/poets/khalid-jamal
Khalid Karrar 	/poets/khalid-karrar
Khalid Khwaja 	/poets/khalid-khwaja
Khalid Mahboob 	/poets/khalid-mahboob
Khalid Mahmood 	/poets/khalid-mahmood
Khalid Mahmood Amar 	/poets/khalid-mahmood-amar
Khalid Mahmood Zaki 	/poets/khalid-mahmood-zaki
KHalid Malik 'Sahil' 	/poets/khalid-malik-sahil
Khalid Moin 	/poets/khalid-moin
Khalid Mubashshir 	/poets/khalid-mubashshir
Khalid Raheem 	/poets/khalid-raheem
Khalid Sharif 	/poets/khalid-sharif
Khalid Shirazi 	/poets/khalid-shirazi
Khalid Siddiqui 	/poets/khalid-siddiqui
Khalid Suhail 	/poets/khalid-suhail
Khalid Yusuf 	/poets/khalid-yusuf
Khalida Uzma 	/poets/khalida-uzma
Khalilur Rahman Azmi 	/poets/khalilur-rahman-azmi
Khalilur Rahman Raz 	/poets/khalilur-rahman-raz
Khaliq aashiq	Abdullah 	/poets/khaliq-aashiq-abdullah
Khalish Barodvi 	/poets/khalish-barodvi
Khalish Dehlvi 	/poets/khalish-dehlvi
Khalish Kalkatvi 	/poets/khalish-kalkatvi
Khamosh Ghazipuri 	/poets/khamosh-ghazipuri
Khan Arzoo Sirajuddin Ali 	/poets/khan-arzoo-sirajuddin-ali
Khan Janbaz 	/poets/khan-janbaz
Khan Mohammad Khaleel 	/poets/khan-mohammad-khaleel
Khan Rizwan 	/poets/khan-rizwan
Khanjar Ghazipuri 	/poets/khanjar-ghazipuri
Khaqan Khavar 	/poets/khaqan-khavar
Khar Dehlavi 	/poets/khar-dehlavi
Khatir Ghaznavi 	/poets/khatir-ghaznavi
Khawaja Javed Akhtar 	/poets/khawaja-javed-akhtar
Khawar Ahmad 	/poets/khawar-ahmad
Khawar Ludhianvi 	/poets/khawar-ludhianvi
Khawar Naqeeb 	/poets/khawar-naqeeb
Khawar Naqvi 	/poets/khawar-naqvi
Khawar Rizvi 	/poets/khawar-rizvi
Khayal Amrohvi 	/poets/khayal-amrohvi
Khizr Barni 	/poets/khizr-barni
Khumar Barabankavi 	/poets/khumar-barabankavi
Khumar Pirzada 	/poets/khumar-pirzada
Khumar Qureshi 	/poets/khumar-qureshi
Khurram Khaleeq 	/poets/khurram-khaleeq
Khurram Khiram Siddiqui 	/poets/khurram-khiram-siddiqui
Khursheed Afsar Baswani 	/poets/khursheed-afsar-baswani
Khursheed Ahmad Malik 	/poets/khursheed-ahmad-malik
Khursheed Akbar 	/poets/khursheed-akbar
Khursheed Beg Malesvi 	/poets/khursheed-beg-malesvi
Khursheed Rizvi 	/poets/khursheed-rizvi
Khurshid Ahmad Jami 	/poets/khurshid-ahmad-jami
Khurshid Akram 	/poets/khurshid-akram
Khurshid Rabbani 	/poets/khurshid-rabbani
Khurshid Sahar 	/poets/khurshid-sahar
Khurshid Talab 	/poets/khurshid-talab
Khurshid-ul-islam 	/poets/khurshid-ul-islam
Khushbir Singh Shaad 	/poets/khushbir-singh-shaad
Khushi Mohammad Naazir 	/poets/khushi-mohammad-naazir
Khvaja riyazuddin atash 	/poets/khvaja-riyazuddin-atash
Khwaja Aminuddin Ameen 	/poets/khwaja-aminuddin-ameen
Khwaja Aziz-ul-Hasan Majzuub 	/poets/khwaja-aziz-ul-hasan-majzuub
Khwaja Mahmood-ul-Hasan 	/poets/khwaja-mahmood-ul-hasan
Khwaja Meer Amani 	/poets/khwaja-meer-amani
Khwaja Meer 'Dard' 	/poets/khwaja-meer-dard
Khwaja Mohammad Vazeer Lakhnavi 	/poets/khwaja-mohammad-vazeer-lakhnavi
Khwaja Mohammad Zakariya 	/poets/khwaja-mohammad-zakariya
Khwaja Rabbani 	/poets/khwaja-rabbani
Khwaja Razi Haidar 	/poets/khwaja-razi-haidar
Khwaja Sajid 	/poets/khwaja-sajid
Kirti Ratan Singh 	/poets/kirti-ratan-singh
Kishan Kumaar Waqaar 	/poets/kishan-kumaar-waqaar
Kishwar Naheed 	/poets/kishwar-naheed
Komal Joya 	/poets/komal-joya
Krishn Adeeb 	/poets/krishn-adeeb
Krishn Bihari Noor 	/poets/krishn-bihari-noor
Krishn Gopal Maghmum 	/poets/krishn-gopal-maghmum
Krishn Murari 	/poets/krishn-murari
Krishna Kumar Naz 	/poets/krishna-kumar-naz
Krishna Kumar Toor 	/poets/krishna-kumar-toor
Krishna Mohan 	/poets/krishna-mohan
Kuldeep Kumar 	/poets/kuldeep-kumar
Kumar Pashi 	/poets/kumar-pashi
Kumar Vishwas 	/poets/kumar-vishwas
Kunwar Bechain 	/poets/kunwar-bechain
Kunwar Ejaz Raja 	/poets/kunwar-ejaz-raja
Kunwar Mahendra Singh Bedi Sahar 	/poets/kunwar-mahendra-singh-bedi-sahar
Laiq Aajiz 	/poets/laiq-aajiz
Laiq Akbar sahaab 	/poets/laiq-akbar-sahaab
Lais Quraishi 	/poets/lais-quraishi
Lal Chand Falak 	/poets/lal-chand-falak
Lala Anoop Chand Aaftab Panipati 	/poets/lala-anoop-chand-aaftab-panipati
Lala Kanji Mil Saba 	/poets/lala-kanji-mil-saba
Lala Madhav Ram Jauhar 	/poets/lala-madhav-ram-jauhar
Lala Tika Ram 	/poets/lala-tika-ram
Lalan Chaudhary 	/poets/lalan-chaudhary
Lata Haya 	/poets/lata-haya
Lateef Sahil 	/poets/lateef-sahil
Laxman Sharma Vahid 	/poets/laxman-sharma-vahid
Laxmi Narayan Farigh 	/poets/laxmi-narayan-farigh
Liaqat Jafri 	/poets/liaqat-jafri
Liyaqat Ali Aasim 	/poets/liyaqat-ali-aasim
Lutf-ur-rahman 	/poets/lutf-ur-rahman
Laiq Aajiz 	/poets/laiq-aajiz
Laiq Akbar sahaab 	/poets/laiq-akbar-sahaab
Lais Quraishi 	/poets/lais-quraishi
Lal Chand Falak 	/poets/lal-chand-falak
Lala Anoop Chand Aaftab Panipati 	/poets/lala-anoop-chand-aaftab-panipati
Lala Kanji Mil Saba 	/poets/lala-kanji-mil-saba
Lala Madhav Ram Jauhar 	/poets/lala-madhav-ram-jauhar
Lala Tika Ram 	/poets/lala-tika-ram
Lalan Chaudhary 	/poets/lalan-chaudhary
Lata Haya 	/poets/lata-haya
Lateef Sahil 	/poets/lateef-sahil
Laxman Sharma Vahid 	/poets/laxman-sharma-vahid
Laxmi Narayan Farigh 	/poets/laxmi-narayan-farigh
Liaqat Jafri 	/poets/liaqat-jafri
Liyaqat Ali Aasim 	/poets/liyaqat-ali-aasim
Lutf-ur-rahman 	/poets/lutf-ur-rahman
M Kothiyavi Rahi 	/poets/m-kothiyavi-rahi
M R Qasmi 	/poets/m-r-qasmi
M. A. Qadeer 	/poets/m-a-qadeer
Maahir Balgiraami 	/poets/maahir-balgiraami
Maatam Fazl Mohammad 	/poets/maatam-fazl-mohammad
Madan Mohan Danish 	/poets/madan-mohan-danish
Madan pal 	/poets/madan-pal
Madhav Awana 	/poets/madhav-awana
Madhu Gupta 	/poets/madhu-gupta
Madhukar Jha Khuddar 	/poets/madhukar-jha-khuddar
Madhuvan Rishi Raj 	/poets/madhuvan-rishi-raj
Mah Laqa Chanda 	/poets/mah-laqa-chanda
Mah Talat Zahidi 	/poets/mah-talat-zahidi
Maharaj Sir Kishan Parashad Shad 	/poets/maharaj-sir-kishan-parashad-shad
Mahaveer Parshad Anjum 	/poets/mahaveer-parshad-anjum
Mahaveer Uttaranchali 	/poets/mahaveer-uttaranchali
Mahboob Khizan 	/poets/mahboob-khizan
Mahboob Zafar 	/poets/mahboob-zafar
Mahender Kumar Sani 	/poets/mahender-kumar-sani
Mahendra Partap Chand 	/poets/mahendra-partap-chand
Mahendra Singh Barq 	/poets/mahendra-singh-barq
Maher Chand Kausar 	/poets/maher-chand-kausar
Mahesh Chandra Naqsh 	/poets/mahesh-chandra-naqsh
Mahesh Janib 	/poets/mahesh-janib
Mahfooz Asar 	/poets/mahfooz-asar
Mahfuzur Rahman Adil 	/poets/mahfuzur-rahman-adil
Mahir Aarwi 	/poets/mahir-aarwi
Mahir Abdul Hayee 	/poets/mahir-abdul-hayee
Mahir Al-Hameedi 	/poets/mahir-al-hameedi
Mahir Sivharvi 	/poets/mahir-sivharvi
Mahirul Qadri 	/poets/mahirul-qadri
Mahmood Ayaz 	/poets/mahmood-ayaz
Mahmood Azhar 	/poets/mahmood-azhar
Mahmood Beg Saaz 	/poets/mahmood-beg-saaz
Mahmood Ghazni 	/poets/mahmood-ghazni
Mahmood Ishqi 	/poets/mahmood-ishqi
Mahmood Khawer 	/poets/mahmood-khawer
Mahmood rae Barelvi 	/poets/mahmood-rae-barelvi
Mahmood Rahim 	/poets/mahmood-rahim
Mahmood Sana 	/poets/mahmood-sana
Mahmood Sarosh 	/poets/mahmood-sarosh
Mahmood Shaam 	/poets/mahmood-shaam
Mahmooda Gaziya 	/poets/mahmooda-gaziya
Mahmood-ul-Hasan 	/poets/mahmood-ul-hasan
Mahshar Badayuni 	/poets/mahshar-badayuni
Mahshar Inayati 	/poets/mahshar-inayati
Mahshar Kazim Husain Lakhnavi 	/poets/mahshar-kazim-husain-lakhnavi
Mahshar Lakhnavi 	/poets/mahshar-lakhnavi
Mahtab Alam 	/poets/mahtab-alam
Mahtab Haider Naqvi 	/poets/mahtab-haider-naqvi
M Kothiyavi Rahi 	/poets/m-kothiyavi-rahi
M R Qasmi 	/poets/m-r-qasmi
M. A. Qadeer 	/poets/m-a-qadeer
Maahir Balgiraami 	/poets/maahir-balgiraami
Maatam Fazl Mohammad 	/poets/maatam-fazl-mohammad
Madan Mohan Danish 	/poets/madan-mohan-danish
Madan pal 	/poets/madan-pal
Madhav Awana 	/poets/madhav-awana
Madhu Gupta 	/poets/madhu-gupta
Madhukar Jha Khuddar 	/poets/madhukar-jha-khuddar
Madhuvan Rishi Raj 	/poets/madhuvan-rishi-raj
Mah Laqa Chanda 	/poets/mah-laqa-chanda
Mah Talat Zahidi 	/poets/mah-talat-zahidi
Maharaj Sir Kishan Parashad Shad 	/poets/maharaj-sir-kishan-parashad-shad
Mahaveer Parshad Anjum 	/poets/mahaveer-parshad-anjum
Mahaveer Uttaranchali 	/poets/mahaveer-uttaranchali
Mahboob Khizan 	/poets/mahboob-khizan
Mahboob Zafar 	/poets/mahboob-zafar
Mahender Kumar Sani 	/poets/mahender-kumar-sani
Mahendra Partap Chand 	/poets/mahendra-partap-chand
Mahendra Singh Barq 	/poets/mahendra-singh-barq
Maher Chand Kausar 	/poets/maher-chand-kausar
Mahesh Chandra Naqsh 	/poets/mahesh-chandra-naqsh
Mahesh Janib 	/poets/mahesh-janib
Mahfooz Asar 	/poets/mahfooz-asar
Mahfuzur Rahman Adil 	/poets/mahfuzur-rahman-adil
Mahir Aarwi 	/poets/mahir-aarwi
Mahir Abdul Hayee 	/poets/mahir-abdul-hayee
Mahir Al-Hameedi 	/poets/mahir-al-hameedi
Mahir Sivharvi 	/poets/mahir-sivharvi
Mahirul Qadri 	/poets/mahirul-qadri
Mahmood Ayaz 	/poets/mahmood-ayaz
Mahmood Azhar 	/poets/mahmood-azhar
Mahmood Beg Saaz 	/poets/mahmood-beg-saaz
Mahmood Ghazni 	/poets/mahmood-ghazni
Mahmood Ishqi 	/poets/mahmood-ishqi
Mahmood Khawer 	/poets/mahmood-khawer
Mahmood rae Barelvi 	/poets/mahmood-rae-barelvi
Mahmood Rahim 	/poets/mahmood-rahim
Mahmood Sana 	/poets/mahmood-sana
Mahmood Sarosh 	/poets/mahmood-sarosh
Mahmood Shaam 	/poets/mahmood-shaam
Mahmooda Gaziya 	/poets/mahmooda-gaziya
Mahmood-ul-Hasan 	/poets/mahmood-ul-hasan
Mahshar Badayuni 	/poets/mahshar-badayuni
Mahshar Inayati 	/poets/mahshar-inayati
Mahshar Kazim Husain Lakhnavi 	/poets/mahshar-kazim-husain-lakhnavi
Mahshar Lakhnavi 	/poets/mahshar-lakhnavi
Mahtab Alam 	/poets/mahtab-alam
Mahtab Haider Naqvi 	/poets/mahtab-haider-naqvi
Mahtab Zafar 	/poets/mahtab-zafar
Mahzar Lakhnavi 	/poets/mahzar-lakhnavi
Maikash Ajmeri 	/poets/maikash-ajmeri
Maikash Akbarabadi 	/poets/maikash-akbarabadi
Maikash Badayuni 	/poets/maikash-badayuni
Maikash Nag Puri 	/poets/maikash-nag-puri
Maimoona Abbas Khan 	/poets/maimoona-abbas-khan
Majaz Jaipuri 	/poets/majaz-jaipuri
Majeed Akhtar 	/poets/majeed-akhtar
Majeed Amjad 	/poets/majeed-amjad
Majeed Lahori 	/poets/majeed-lahori
Majeed Maiman 	/poets/majeed-maiman
Majid Deobandi 	/poets/majid-deobandi
Majid Siddiqui 	/poets/majid-siddiqui
Majid-ul-Baqri 	/poets/majid-ul-baqri
Majnoon Gorakhpuri 	/poets/majnoon-gorakhpuri
Majrooh Sultanpuri 	/poets/majrooh-sultanpuri
makeen Ahsan Kaleem 	/poets/makeen-ahsan-kaleem
Makhdoom Mohiuddin 	/poets/makhdoom-mohiuddin
Makhdoom Munawwar 	/poets/makhdoom-munawwar
Makhmoor Dehlvi 	/poets/makhmoor-dehlvi
Makhmoor Jalandhari 	/poets/makhmoor-jalandhari
Makhmoor Kunwar 	/poets/makhmoor-kunwar
Makhmoor Saeedi 	/poets/makhmoor-saeedi
Malik Ehsan 	/poets/malik-ehsan
Malika Naseem 	/poets/malika-naseem
Malikzada Javed 	/poets/malikzada-javed
Malikzada Manzoor Ahmad 	/poets/malikzada-manzoor-ahmad
Mamnoon Nizamuddin 	/poets/mamnoon-nizamuddin
Mamta Tiwari 	/poets/mamta-tiwari
Mani Jayasi 	/poets/mani-jayasi
Manish Shukla 	/poets/manish-shukla
Manmohan Talkh 	/poets/manmohan-talkh
Mannan Bijnori 	/poets/mannan-bijnori
Manohar Lal  Hadi 	/poets/manohar-lal-hadi
Manohar Sahaye Anwar 	/poets/manohar-sahaye-anwar
Manoj Azhar 	/poets/manoj-azhar
Mansoor Aafaque 	/poets/mansoor-aafaque
Mansoor Ahmad 	/poets/mansoor-ahmad
Mansoor Khushtar 	/poets/mansoor-khushtar
Mansoor Multani 	/poets/mansoor-multani
Mansoor Usmani 	/poets/mansoor-usmani
Mansoora Ahmad 	/poets/mansoora-ahmad
Manzar Ayubi 	/poets/manzar-ayubi
Manzar Bhopali 	/poets/manzar-bhopali
Manzar Lakhnavi 	/poets/manzar-lakhnavi
Manzar Mufti 	/poets/manzar-mufti
Manzar Naqvi 	/poets/manzar-naqvi
Manzar Saleem 	/poets/manzar-saleem
Manzar Shahab 	/poets/manzar-shahab
Manzoor Ahmad Manzoor 	/poets/manzoor-ahmad-manzoor
Manzoor Ali Rahi 	/poets/manzoor-ali-rahi
Manzoor Arif 	/poets/manzoor-arif
Manzoor Depalpuri 	/poets/manzoor-depalpuri
Manzoor Hashmi 	/poets/manzoor-hashmi
Manzoor Husain shor 	/poets/manzoor-husain-shor
Manzoor Imakni 	/poets/manzoor-imakni
Maqbool Aamir 	/poets/maqbool-aamir
Maqbool Husain Syed Karnal 	/poets/maqbool-husain-syed-karnal
Maqbool Naqsh 	/poets/maqbool-naqsh
Maqsood Wafa 	/poets/maqsood-wafa
Marahib Qasmi 	/poets/marahib-qasmi
Maratib Akhtar 	/poets/maratib-akhtar
Mardan Ali Khan Rana 	/poets/mardan-ali-khan-rana
Mardan Safi 	/poets/mardan-safi
Marghoob Ali 	/poets/marghoob-ali
Marghoob Asar Fatmi 	/poets/marghoob-asar-fatmi
Marghoob Hasan 	/poets/marghoob-hasan
Maroof Dehlvi 	/poets/maroof-dehlvi
Maroof Ray barelvi 	/poets/maroof-ray-barelvi
Maryam Naz 	/poets/maryam-naz
Maryam Tasleem Kiyani 	/poets/maryam-tasleem-kiyani
Mashkoor Husain Yaad 	/poets/mashkoor-husain-yaad
Mashkoor Mamnoon Qannauji 	/poets/mashkoor-mamnoon-qannauji
Masood Akhtar Jamal 	/poets/masood-akhtar-jamal
Masood Anwar Shafaqi 	/poets/masood-anwar-shafaqi
Masood Hasan 	/poets/masood-hasan
Masood Hassas 	/poets/masood-hassas
Masood Maikash Muradabadi 	/poets/masood-maikash-muradabadi
Masood Mirza Niyazi 	/poets/masood-mirza-niyazi
Masood Munavvar 	/poets/masood-munavvar
Masood Qureshi 	/poets/masood-qureshi
Masooda Hayat 	/poets/masooda-hayat
Masoom Sharqi 	/poets/masoom-sharqi
Masoom Sheerazi 	/poets/masoom-sheerazi
Masroor Anwar 	/poets/masroor-anwar
Masud Husain Khan 	/poets/masud-husain-khan
Mateen Sarosh 	/poets/mateen-sarosh
Matin Niazi 	/poets/matin-niazi
Mauj Fatehgarhi 	/poets/mauj-fatehgarhi
Maya Khanna Raje Barelvi 	/poets/maya-khanna-raje-barelvi
Mayal Khairabadi 	/poets/mayal-khairabadi
Mayank Awasthi 	/poets/mayank-awasthi
Mazaq Badayuni  	/poets/mazaq-badayuni
Mazhar Abbas 	/poets/mazhar-abbas
Mazhar Imam 	/poets/mazhar-imam
Mazhar Mirza Jaan-e-Janaan 	/poets/mazhar-mirza-jaan-e-janaan
Meem Hasan Lateefi 	/poets/meem-hasan-lateefi
Meena Kumari 	/poets/meena-kumari
Meena Naqvi 	/poets/meena-naqvi
meenakshi jijivisha 	/poets/meenakshi-jijivisha
Meer Ahmad Naved 	/poets/meer-ahmad-naved
Meer Ali Ausat Rashk 	/poets/meer-ali-ausat-rashk
Meer Anees 	/poets/meer-anees
Meer Asar 	/poets/meer-asar
Meer Basheer 	/poets/meer-basheer
Meer Hasan 	/poets/meer-hasan
Meer Kallu Arsh 	/poets/meer-kallu-arsh
Meer Mehdi Majrooh 	/poets/meer-mehdi-majrooh
Meer Mohammad Baqar Hazin 	/poets/meer-mohammad-baqar-hazin
Meer Mohammad Sultan Aaqil 	/poets/meer-mohammad-sultan-aaqil
Meer Mohammadi Bedar 	/poets/meer-mohammadi-bedar
Meer Mustahsan Khaleeq 	/poets/meer-mustahsan-khaleeq
Meer Naqi Ali Khan Saqib 	/poets/meer-naqi-ali-khan-saqib
Meer Qamruddin Mannat 	/poets/meer-qamruddin-mannat
Meer Sayed Nazeer Husain Nashad 	/poets/meer-sayed-nazeer-husain-nashad
Meer Shamsuddeen Faqeer 	/poets/meer-shamsuddeen-faqeer
Meer Soz 	/poets/meer-soz
Meer Tahir Ali Tahir Farrukhabadi 	/poets/meer-tahir-ali-tahir-farrukhabadi
Meer Yaseen Ali khan 	/poets/meer-yaseen-ali-khan
Meer Ziauddin Zia 	/poets/meer-ziauddin-zia
Meeraji 	/poets/meeraji
Meeran Hashmi 	/poets/meeran-hashmi
Meerza Jawan Bakht Jahandar 	/poets/meerza-jawan-bakht-jahandar
Megi Asnani 	/poets/megi-asnani
Mehboob Azmi 	/poets/mehboob-azmi
Mehboob Rahi 	/poets/mehboob-rahi
Mehdi Jafar 	/poets/mehdi-jafar
Mehdi Pratapgarhi 	/poets/mehdi-pratapgarhi
Mehshar Afridi 	/poets/mehshar-afridi
Mehwar Noori 	/poets/mehwar-noori
Mela Ram Wafa 	/poets/mela-ram-wafa
Meraj Faizabadi 	/poets/meraj-faizabadi
Meraj Lakhnavi 	/poets/meraj-lakhnavi
Meraj Naqvi 	/poets/meraj-naqvi
Midhat-ul-Akhtar 	/poets/midhat-ul-akhtar
Miir Sher Alii Afsos 	/poets/miir-sher-alii-afsos
Minu Bakshi 	/poets/minu-bakshi
Mir Sajjad 	/poets/mir-sajjad
Mir Taqi Mir 	/miiriyaat
Mirza Abdul Ghafoor Gorgani arshad 	/poets/mirza-abdul-ghafoor-gorgani-arshad
Mirza Ali Lutf 	/poets/mirza-ali-lutf
Mirza Altaf Husain Alim Lucknowi 	/poets/mirza-altaf-husain-alim-lucknowi
Mirza Asman Jah Anjum 	/poets/mirza-asman-jah-anjum
Mirza Athar Zia 	/poets/mirza-athar-zia
Mirza Azfari 	/poets/mirza-azfari
Mirza Ghalib 	/poets/mirza-ghalib
Mirza Hadi Ruswa 	/poets/mirza-hadi-ruswa
Mirza Haider Ali Hairan 	/poets/mirza-haider-ali-hairan
Mirza Husain Ali Mehnat 	/poets/mirza-husain-ali-mehnat
Mirza Ibraheem Beg Maqtool 	/poets/mirza-ibraheem-beg-maqtool
Mirza Mahmood Sarhadi 	/poets/mirza-mahmood-sarhadi
Mirza Maseeta Beg Muntahi 	/poets/mirza-maseeta-beg-muntahi
Mirza Mayal Dehlvi 	/poets/mirza-mayal-dehlvi
Mirza Mohammad Nayar 	/poets/mirza-mohammad-nayar
Mirza Mohammad Taqi Hawas 	/poets/mirza-mohammad-taqi-hawas
Mirza Naeem Beg Jawan 	/poets/mirza-naeem-beg-jawan
Mirza Qadir Bakhsh Sabir Dehlavi 	/poets/mirza-qadir-bakhsh-sabir-dehlavi
Mirza Rahimuddin Haya 	/poets/mirza-rahimuddin-haya
Mirza Raza Barq 	/poets/mirza-raza-barq
Mirza Raza Quli Ashufta 	/poets/mirza-raza-quli-ashufta
Mirza Shauq Lakhnavi 	/poets/mirza-shauq-lakhnavi
Misam Ali Aagha 	/poets/misam-ali-aagha
Misdaque Azmi 	/poets/misdaque-azmi
Miskeen Shah 	/poets/miskeen-shah
Miyan dad Khan Sayyah 	/poets/miyan-dad-khan-sayyah
Miyan Haji Tajalli 	/poets/miyan-haji-tajalli
Miyan Noor-ul-Islam Muntazir 	/poets/miyan-noor-ul-islam-muntazir
Moghisuddin Fareedi 	/poets/moghisuddin-fareedi
Mohaamad Nasim Qureshi 	/poets/mohaamad-nasim-qureshi
Mohammad Aazam 	/poets/mohammad-aazam
Mohammad Abbas Safiir 	/poets/mohammad-abbas-safiir
Mohammad Abdul Hameed Siddiqi Nazar Lakhnawi 	/poets/mohammad-abdul-hameed-siddiqi-nazar-lakhnawi
Mohammad Abid Ali Abid 	/poets/mohammad-abid-ali-abid
Mohammad Afsar Sajid 	/poets/mohammad-afsar-sajid
Mohammad Aftab Ahmad Saqib 	/poets/mohammad-aftab-ahmad-saqib
Mohammad Ahmad 	/poets/mohammad-ahmad
Mohammad Ahmad Ramz 	/poets/mohammad-ahmad-ramz
Mohammad Ajmal Niyazi 	/poets/mohammad-ajmal-niyazi
Mohammad Akbar Niyazi 	/poets/mohammad-akbar-niyazi
Mohammad Ali Asar 	/poets/mohammad-ali-asar
Mohammad Ali Jauhar 	/poets/mohammad-ali-jauhar
Mohammad Ali Khan Rashki 	/poets/mohammad-ali-khan-rashki
Mohammad Ali Manzar  	/poets/mohammad-ali-manzar
Mohammad Ali Mauj 	/poets/mohammad-ali-mauj
Mohammad Ali Sahil 	/poets/mohammad-ali-sahil
Mohammad Ali Tishna 	/poets/mohammad-ali-tishna
Mohammad Alvi 	/poets/mohammad-alvi
Mohammad Amaan Nisar 	/poets/mohammad-amaan-nisar
Mohammad Amir Azam Quraishi 	/poets/mohammad-amir-azam-quraishi
Mohammad Anvar Khalid 	/poets/mohammad-anvar-khalid
Mohammad Aslam Khan Aslam 	/poets/mohammad-aslam-khan-aslam
Mohammad Azeem 	/poets/mohammad-azeem
Mohammad Azhar Shams 	/poets/mohammad-azhar-shams
Mohammad Deen Taseer 	/poets/mohammad-deen-taseer
Mohammad Faizullah Faiz 	/poets/mohammad-faizullah-faiz
Mohammad Fakhrul Haq Noori 	/poets/mohammad-fakhrul-haq-noori
Mohammad Firoz Shah 	/poets/mohammad-firoz-shah
Mohammad Haneef Rame 	/poets/mohammad-haneef-rame
Mohammad Hazim Hassan 	/poets/mohammad-hazim-hassan
Mohammad Isa Tanha 	/poets/mohammad-isa-tanha
Mohammad Izhar ul Haq 	/poets/mohammad-izhar-ul-haq
Mohammad Khalid 	/poets/mohammad-khalid
Mohammad Mansha ur Rahman Khan Mansha 	/poets/mohammad-mansha-ur-rahman-khan-mansha
Mohammad Mubashshir Mayo 	/poets/mohammad-mubashshir-mayo
Mohammad Mukhtar Ali 	/poets/mohammad-mukhtar-ali
Mohammad Mustahsan Jami 	/poets/mohammad-mustahsan-jami
Mohammad Naeemullah Khayali 	/poets/mohammad-naeemullah-khayali
Mohammad Naqi Rizvi Asr 	/poets/mohammad-naqi-rizvi-asr
Mohammad Naved Mirza 	/poets/mohammad-naved-mirza
Mohammad Osama Khaki 	/poets/mohammad-osama-khaki
Mohammad Sadiq Qamar 	/poets/mohammad-sadiq-qamar
Mohammad Sadiq Zia 	/poets/mohammad-sadiq-zia
Mohammad Sajjad Mirza 	/poets/mohammad-sajjad-mirza
Mohammad Saleem Sagar 	/poets/mohammad-saleem-sagar
Mohammad Saleem Tahir 	/poets/mohammad-saleem-tahir
Mohammad Saleemur Rahman 	/poets/mohammad-saleemur-rahman
Mohammad Salim 	/poets/mohammad-salim
Mohammad Shahbaz Akmal 	/poets/mohammad-shahbaz-akmal
Mohammad Siddiq Saib Tonki 	/poets/mohammad-siddiq-saib-tonki
Mohammad Tanviruzzaman 	/poets/mohammad-tanviruzzaman
Mohammad Usmaan Arif 	/poets/mohammad-usmaan-arif
Mohammad Wilayatullah 	/poets/mohammad-wilayatullah
Mohammad Yaqoob Aasi 	/poets/mohammad-yaqoob-aasi
Mohammad Yar Khaksar 	/poets/mohammad-yar-khaksar
Mohammad Yusuf Ali Khan Nazim Rampuri 	/poets/mohammad-yusuf-ali-khan-nazim-rampuri
Mohammad Yusuf Papa 	/poets/mohammad-yusuf-papa
Mohammad Yusuf Rasikh 	/poets/mohammad-yusuf-rasikh
Mohammad Zakariyya Khan 	/poets/mohammad-zakariyya-khan
Mohammed Nabi Khan Jamal Soveda 	/poets/mohammed-nabi-khan-jamal-soveda
Mohan Javidani 	/poets/mohan-javidani
Mohan Seerat Ajmeri 	/poets/mohan-seerat-ajmeri
Mohan Singh Oberoi Deewana 	/poets/mohan-singh-oberoi-deewana
Moheet Ismaeel 	/poets/moheet-ismaeel
Mohsin Aftab Kelapuri 	/poets/mohsin-aftab-kelapuri
Mohsin Asrar 	/poets/mohsin-asrar
Mohsin Bhopali 	/poets/mohsin-bhopali
Mohsin Changezi 	/poets/mohsin-changezi
Mohsin Ehsan 	/poets/mohsin-ehsan
Mohsin Jalganvi 	/poets/mohsin-jalganvi
Mohsin Naqvi 	/poets/mohsin-naqvi
Mohsin Shaikh 	/poets/mohsin-shaikh
Mohsin Shakeel 	/poets/mohsin-shakeel
Mohsin Zaidi 	/poets/mohsin-zaidi
Moid Rashidi 	/poets/moid-rashidi
Moin Ahsan Jazbi 	/poets/moin-ahsan-jazbi
Moin Najmi 	/poets/moin-nizami
Moin Nizaamii 	/poets/moin-nizaamii
Moin Shadab 	/poets/moin-shadab
Moin Tabish 	/poets/moin-tabish
Momin Khan Momin 	/poets/momin-khan-momin
Moni Gopal Tapish 	/poets/moni-gopal-tapish
Monika Sharma Sarthi 	/poets/monika-sharma-sarthi
Monika Singh 	/poets/monika-singh
Moosa Raza 	/poets/moosa-raza
Mubarak Ansari 	/poets/mubarak-ansari
Mubarak Azimabadi 	/poets/mubarak-azimabadi
Mubarak Haider 	/poets/mubarak-haider
Mubarak Shamim 	/poets/mubarak-shamim
Mubashshir Ali Zaidi 	/authors/mubashshir-ali-zaidi
Mubashshir Saeed 	/poets/mubashshir-saeed
Mubeen Mirza 	/poets/mubeen-mirza
Mufti Sadruddin Aazurda 	/poets/mufti-sadruddin-aazurda
Mughal Farooq Parwaz 	/poets/mughal-farooq-parwaz
Mughni Tabassum 	/poets/mughni-tabassum
Muhammad Ayyub Zauqi 	/poets/muhammad-ayyub-zauqi
Muhib Aarfi 	/poets/muhib-aarfi
Muhib Kausar 	/poets/muhib-kausar
Muhiuddin Fauq 	/poets/muhiuddin-fauq
Muhiuddin Irfan 	/poets/muhiuddin-irfan
Mujahid Faraaz 	/poets/mujahid-faraaz
Mujeeb Iman 	/poets/mujeeb-iman
Mujeeb Khairabadi 	/poets/mujeeb-khairabadi
Mujeeb Zafar Anwar Hameedi 	/poets/mujeeb-zafar-anwar-hameedi
Mukesh Alam 	/poets/mukesh-alam
Mukhlis Wajdani 	/poets/mukhlis-wajdani
Mukhtar Ahmad Kausar 	/poets/mukhtar-ahmad-kausar
Mukhtar Hashmi 	/poets/mukhtar-hashmi
Mukhtar Javed 	/poets/mukhtar-javed
Mukhtar Shameem 	/poets/mukhtar-shameem
Mukhtar Siddiqui 	/poets/mukhtar-siddiqui
Mumtaz Ahmad Khan Khushtar 	/poets/mumtaz-ahmad-khan-khushtar
Mumtaz Athar 	/poets/mumtaz-athar
Mumtaz Gurmani 	/poets/mumtaz-gurmani
Mumtaz Kanwal 	/poets/mumtaz-kanwal
Mumtaz Malik 	/poets/mumtaz-malik
Mumtaz Mazi 	/poets/mumtaz-mazi
Mumtaz Mirza 	/poets/mumtaz-mirza
Mumtaz Naseem 	/poets/mumtaz-naseem
Mumtaz Rashid 	/poets/mumtaz-rashid
Munawar Khan Ghafil 	/poets/munawar-khan-ghafil
Munawwar Aziz 	/poets/munawwar-aziz
Munawwar Hashmi 	/poets/munawwar-hashmi
Munawwar Jameel 	/poets/munawwar-jameel
Munawwar Lakhnavi 	/poets/munawwar-lakhnavi
Munawwar Rana 	/poets/munawwar-rana
Muneebur Rahman 	/poets/muneebur-rahman
Muneer Ahmad Firdaus 	/poets/muneer-ahmad-firdaus
Muneer Ahmad Jami 	/poets/muneer-ahmad-jami
Muneer Ahmad Muneer Dehlvi 	/poets/muneer-ahmad-muneer-dehlvi
Muneer Fatmi 	/poets/muneer-fatmi
Muneer Niyazi 	/poets/muneer-niyazi
Muneer Saifi 	/poets/muneer-saifi
muneer saifi 	/poets/muneer-saifi-1
Muneer Shikohabadi 	/poets/muneer-shikohabadi
Muneeruddin Sahar Saeedi 	/poets/muneeruddin-sahar-saeedi
Munir Arman Nasimi 	/authors/munir-arman-nasimi
Munshi Banwari Lal Shola 	/poets/munshi-banwari-lal-shola
Munshi Bihari Lal Mushtaq Dehlwi 	/poets/munshi-bihari-lal-mushtaq-dehlwi
Munshi Debi Parshad Sahar Badayuni 	/poets/munshi-debi-parshad-sahar-badayuni
Munshi Jwala Parshad Barq 	/poets/munshi-jwala-parshad-barq
Munshi Khairati Laal Shagufta 	/poets/munshi-khairati-laal-shagufta
Munshi Naubat Rai Nazar Lakhnavi 	/poets/munshi-naubat-rai-nazar-lakhnavi
Muntazir Firozabadi 	/poets/muntazir-firozabadi
Muntazir lakhnavi 	/poets/muntazir-lakhnavi
Muqeem Ehsan Kaleem 	/poets/muqeem-ehsan-kaleem
Muqsit Nadeem 	/poets/muqsit-nadeem
Murli Dhar Shad 	/poets/murli-dhar-shad
Murlidhar Sharma Talib 	/poets/murlidhar-sharma-talib
Murtaza Ali Shad 	/poets/murtaza-ali-shad
Murtaza Birlas 	/poets/murtaza-birlas
Musarrat Hashmi 	/poets/musarrat-hashmi
Musavvir Firozpuri 	/poets/musavvir-firozpuri
Musavvir Sabzwari 	/poets/musavvir-sabzwari
Mushaf Iqbal Tausifi 	/poets/mushaf-iqbal-tausifi
Mushafi Ghulam Hamdani 	/poets/mushafi-ghulam-hamdani
Mushfiq Khwaja 	/poets/mushfiq-khwaja
Mushir Jhanjhanvi 	/poets/mushir-jhanjhanvi
Mushtaq Aazar Fareedi 	/poets/mushtaq-aazar-fareedi
Mushtaq Ahmad Noori 	/poets/mushtaq-ahmad-noori
Mushtaq Ajiz 	/poets/mushtaq-ajiz
Mushtaq Ali Shahid 	/poets/mushtaq-ali-shahid
Mushtaq Anjum 	/poets/mushtaq-anjum
Mushtaq Naqvi 	/poets/mushtaq-naqvi
Mushtaq Sadaf 	/poets/mushtaq-sadaf
Mushtaq Shad 	/poets/mushtaq-shad
Mushtaq Singh 	/poets/mushtaq-singh
Muslim Ansari 	/poets/muslim-ansari
Muslim Saleem 	/poets/muslim-saleem
Muslim Shameem 	/poets/muslim-shameem
mustafa arbab 	/poets/mustafa-arbab
Mustafa Shahab 	/poets/mustafa-shahab
Mustafa Zaidi 	/poets/mustafa-zaidi
Mustahsin Khayal  	/poets/mustahsin-khayal
Mutrib Nizami 	/poets/mutrib-nizami
Muzaffar Abdali 	/poets/muzaffar-abdali
Muzaffar Ahmad Muzaffar 	/poets/muzaffar-ahmad-muzaffar
Muzaffar Ali Aseer 	/poets/muzaffar-ali-aseer
Muzaffar Ali Syed 	/poets/muzaffar-ali-syed
Muzaffar Bukhari 	/poets/muzaffar-bukhari
Muzaffar Hanfi 	/poets/muzaffar-hanfi
Muzaffar Iraj 	/poets/muzaffar-iraj
Muzaffar Mumtaz 	/poets/muzaffar-mumtaz
Muzaffar Razmi 	/poets/muzaffar-razmi
Muzaffar Shikoh 	/poets/muzaffar-shikoh
Muzaffar Warsi 	/poets/muzaffar-warsi
Muzammil Husain Cheema 	/poets/muzammil-husain-cheema
Muzdam Khan 	/poets/muzdam-khan
Muztar Haidri 	/poets/muztar-haidri
Muztar Khairabadi 	/poets/muztar-khairabadi
Naaz Muradabadi 	/poets/naaz-muradabadi
Nabeel Ahmad Nabeel 	/poets/nabeel-ahmad-nabeel
Nadeem ahmad 	/poets/nadeem-ahmad
Nadeem Bhabha 	/poets/nadeem-bhabha
Nadeem Farrukh 	/poets/nadeem-farrukh
Nadeem Fazli 	/poets/nadeem-fazli
Nadeem Goyai 	/poets/nadeem-goyai
Nadeem Gullani 	/poets/nadeem-gullani
Nadeem Mahir 	/poets/nadeem-mahir
Nadeem Siddiqui 	/poets/nadeem-siddiqui
Nadeem Sirsivi 	/poets/nadeem-sirsivi
Nadim Nadeem 	/poets/nadim-nadeem
Nadir Areez 	/poets/nadir-areez
Nadir Kakorvi 	/poets/nadir-kakorvi
Nadir Lakhnavi 	/poets/nadir-lakhnavi
Nadir Shahjahanpuri 	/poets/nadir-shahjahanpuri
Nadir Siddiqui 	/poets/nadir-siddiqui
Nadiya ambar lodhi 	/poets/nadiya-ambar-lodhi
Naeem Akhtar 	/poets/naeem-akhtar
Naeem Akhtar Khadimi 	/poets/naeem-akhtar-khadimi
Naeem Gilani 	/poets/naeem-gilani
Naeem Raza Bhatti 	/poets/naeem-raza-bhatti
Naeem Sarmad 	/poets/naeem-sarmad
Naeem Zarrar Ahmad 	/poets/naeem-zarrar-ahmad
Nafas Ambalvi 	/poets/nafas-ambalvi
Nafeer Sarmadi 	/poets/nafeer-sarmadi
Naheed Kausar 	/poets/naheed-kausar
Naheed Virk 	/poets/naheed-virk
Nahid Qamar 	/poets/nahid-qamar
Nahid Qasmi 	/poets/nahid-qasmi
Nahid Rana 	/poets/nahid-rana
Naim Siddiqi 	/poets/naim-siddiqi
Naina Adil 	/poets/naina-adil
Najeeb Ahmad 	/poets/najeeb-ahmad
Najeeb Ramish 	/poets/najeeb-ramish
Najeeba Arif 	/poets/najeeba-arif
Naji Shakir 	/poets/naji-shakir
Najm Aafandi 	/poets/najm-aafandi
Najma Khan 	/poets/najma-khan
Najma Shaheen Khosa 	/poets/najma-shaheen-khosa
Najmi Siddiqui 	/poets/najmi-siddiqui
Najmus Saqib 	/poets/najmus-saqib
Nakhshab Jaarchawi 	/poets/nakhshab-jaarchawi
Nami Ansari 	/poets/nami-ansari
Naqqash Abidi 	/poets/naqqash-abidi
Naqqash Kazmi 	/poets/naqqash-kazmi
Naqsh Layalpuri 	/poets/naqsh-layalpuri
Naresh Kumar Dard 	/poets/naresh-kumar-dard
Naresh Kumar Shad 	/poets/naresh-kumar-shad
Narjis Afroz Zaidi 	/poets/narjis-afroz-zaidi
Naaz Muradabadi 	/poets/naaz-muradabadi
Nabeel Ahmad Nabeel 	/poets/nabeel-ahmad-nabeel
Nadeem ahmad 	/poets/nadeem-ahmad
Nadeem Bhabha 	/poets/nadeem-bhabha
Nadeem Farrukh 	/poets/nadeem-farrukh
Nadeem Fazli 	/poets/nadeem-fazli
Nadeem Goyai 	/poets/nadeem-goyai
Nadeem Gullani 	/poets/nadeem-gullani
Nadeem Mahir 	/poets/nadeem-mahir
Nadeem Siddiqui 	/poets/nadeem-siddiqui
Nadeem Sirsivi 	/poets/nadeem-sirsivi
Nadim Nadeem 	/poets/nadim-nadeem
Nadir Areez 	/poets/nadir-areez
Nadir Kakorvi 	/poets/nadir-kakorvi
Nadir Lakhnavi 	/poets/nadir-lakhnavi
Nadir Shahjahanpuri 	/poets/nadir-shahjahanpuri
Nadir Siddiqui 	/poets/nadir-siddiqui
Nadiya ambar lodhi 	/poets/nadiya-ambar-lodhi
Naeem Akhtar 	/poets/naeem-akhtar
Naeem Akhtar Khadimi 	/poets/naeem-akhtar-khadimi
Naeem Gilani 	/poets/naeem-gilani
Naeem Raza Bhatti 	/poets/naeem-raza-bhatti
Naeem Sarmad 	/poets/naeem-sarmad
Naeem Zarrar Ahmad 	/poets/naeem-zarrar-ahmad
Nafas Ambalvi 	/poets/nafas-ambalvi
Nafeer Sarmadi 	/poets/nafeer-sarmadi
Naheed Kausar 	/poets/naheed-kausar
Naheed Virk 	/poets/naheed-virk
Nahid Qamar 	/poets/nahid-qamar
Nahid Qasmi 	/poets/nahid-qasmi
Nahid Rana 	/poets/nahid-rana
Naim Siddiqi 	/poets/naim-siddiqi
Naina Adil 	/poets/naina-adil
Najeeb Ahmad 	/poets/najeeb-ahmad
Najeeb Ramish 	/poets/najeeb-ramish
Najeeba Arif 	/poets/najeeba-arif
Naji Shakir 	/poets/naji-shakir
Najm Aafandi 	/poets/najm-aafandi
Najma Khan 	/poets/najma-khan
Najma Shaheen Khosa 	/poets/najma-shaheen-khosa
Najmi Siddiqui 	/poets/najmi-siddiqui
Najmus Saqib 	/poets/najmus-saqib
Nakhshab Jaarchawi 	/poets/nakhshab-jaarchawi
Nami Ansari 	/poets/nami-ansari
Naqqash Abidi 	/poets/naqqash-abidi
Naqqash Kazmi 	/poets/naqqash-kazmi
Naqsh Layalpuri 	/poets/naqsh-layalpuri
Naresh Kumar Dard 	/poets/naresh-kumar-dard
Naresh Kumar Shad 	/poets/naresh-kumar-shad
Narjis Afroz Zaidi 	/poets/narjis-afroz-zaidi
Naseem Abbasi 	/poets/naseem-abbasi
Naseem Ahmad Naseem 	/poets/naseem-ahmad-naseem
Naseem Ansari 	/poets/naseem-ansari
Naseem Bharat Puri 	/poets/naseem-bharat-puri
Naseem Dehlvi 	/poets/naseem-dehlvi
Naseem Nazish 	/poets/naseem-nazish
Naseem Nikhat 	/poets/naseem-nikhat
Naseem Noor Mahali 	/poets/naseem-noor-mahali
Naseem Sahar 	/poets/naseem-sahar
Naseem Sailpuri 	/poets/naseem-sailpuri
Naseem Shahjahanpuri 	/poets/naseem-shahjahanpuri
Naseem Shekh 	/poets/naseem-shekh
Naseem Siddiqi 	/poets/naseem-siddiqi
Naseem Syed 	/poets/naseem-syed
Naseer Ahmad Nasir 	/poets/naseer-ahmad-nasir
Naseer Arzoo 	/poets/naseer-arzoo
Naseer Koti 	/poets/naseer-koti
Naseer Parwaz 	/poets/naseer-parwaz
Naseer Turabi 	/poets/naseer-turabi
Naseeruddin 	/poets/naseeruddin
Nashir Naqvi 	/poets/nashir-naqvi
Nashtar Amrohvi 	/poets/nashtar-amrohvi
Nashtar Khaanqahi 	/poets/nashtar-khaanqahi
Nasim Maysori 	/poets/nasim-maysori
Nasir Ali Syed 	/poets/nasir-ali-syed
Nasir Amrohvi 	/poets/nasir-amrohvi
Nasir Aqeel 	/poets/nasir-aqeel
Nasir Baluch 	/poets/nasir-baluch
Nasir Basheer 	/poets/nasir-basheer
Nasir chaudhri 	/poets/nasir-chaudhri
Nasir Jaunpuri 	/poets/nasir-jaunpuri
Nasir Kazmi 	/poets/nasir-kazmi
Nasir Rao 	/poets/nasir-rao
Nasir Shahzad 	/poets/nasir-shahzad
Nasir Zaidi 	/poets/nasir-zaidi
Nasr Ghazali 	/poets/nasr-ghazali
Nasreen Anjum Bhatti 	/poets/nasreen-anjum-bhatti
Nasreen Anjum Sethi 	/poets/nasreen-anjum-sethi
Nasreen Naqqash 	/poets/nasreen-naqqash
Natiq Gulavthi 	/poets/natiq-gulavthi
Natiq Lakhnavi 	/poets/natiq-lakhnavi
Nau Bahar Sabir 	/poets/nau-bahar-sabir
Naufil Arya 	/poets/naufil-arya
Naushad Ahmad Kareemi 	/poets/naushad-ahmad-kareemi
Naushad Ali 	/poets/naushad-ali
Navab Mohammad Yar Khan Ameer 	/poets/navab-mohammad-yar-khan-ameer
Naved Raza 	/poets/naved-raza
Navin C. Chaturvedi 	/poets/navin-c-chaturvedi
Navneet Sharma 	/poets/navneet-sharma
Nawab Ahsan 	/poets/nawab-ahsan
Nawab Moazzam Jah Shaji 	/poets/nawab-moazzam-jah-shaji
Nawab Shahabadi 	/poets/nawab-shahabadi
Nawab Shahjahan Begum Shahjahan 	/poets/nawab-shahjahan-begum-shahjahan
Nawab Sulaiman Shikoh 	/poets/nawab-sulaiman-shikoh
Nawab Ziauddin Khan Rakhshaan 	/poets/nawab-ziauddin-khan-rakhshaan
Nawaz Asimi 	/poets/nawaz-asimi
Nawaz Deobandi 	/poets/nawaz-deobandi
nawed malik 	/poets/nawed-malik
Nayab 	/poets/nayab
nayan sukh 	/poets/nayan-sukh
Nayyar Aasmi 	/poets/nayyar-aasmi
Nayyar Qureshi Gangohi 	/poets/nayyar-qureshi-gangohi
Nayyar Sultanpuri 	/poets/nayyar-sultanpuri
Nayyar Wasti 	/poets/nayyar-wasti
Naz Butt 	/poets/naz-butt
Naz Layalpuri 	/poets/naz-layalpuri
Naz Naz Khialvi 	/poets/naz-naz-khialvi
Naz Qadri 	/poets/naz-qadri
Nazar Barni 	/poets/nazar-barni
Nazar Hyderabadi 	/poets/nazar-hyderabadi
Nazar Javed 	/poets/nazar-javed
Nazar Kanpuri 	/poets/nazar-kanpuri
Nazar Siddiqui 	/poets/nazar-siddiqui
Nazeer Ahmad Naji 	/poets/nazeer-ahmad-naji
Nazeer Akbarabadi 	/poets/nazeer-akbarabadi
Nazeer Azad 	/poets/nazeer-azad
Nazeer Baaqri 	/poets/nazeer-baaqri
Nazeer Banarasi 	/poets/nazeer-banarasi
Nazeer Meeruthy 	/poets/nazeer-meeruthy
Nazeer Mirza Barlas 	/poets/nazeer-mirza-barlas
Nazeer Mohsin 	/poets/nazeer-mohsin
Nazeer Muzaffarpuri 	/poets/nazeer-muzaffarpuri
Nazeer Nazar 	/poets/nazeer-nazar
Nazeer Qaisar 	/poets/nazeer-qaisar
Nazeer Rampuri 	/poets/nazeer-rampuri
Nazeer Siddiqui 	/poets/nazeer-siddiqui
nazeer Tabassum 	/poets/nazeer-tabassum
Nazim Barelvi 	/poets/nazim-barelvi
Nazim Naqvi 	/poets/nazim-naqvi
Nazim Sultanpuri 	/poets/nazim-sultanpuri
Nazir Al-Husaini 	/poets/nazir-al-husaini
Nazir Fatehpuri 	/poets/nazir-fatehpuri
Nazir Siddiqi 	/poets/nazir-siddiqi
Nazir Wahid 	/poets/nazir-wahid
Nazish Kashmiri 	/poets/nazish-kashmiri
Nazish Partap Gadhi 	/poets/nazish-partap-gadhi
Nazish Rizvi 	/poets/nazish-rizvi
Nazish Sikandarpuri 	/poets/nazish-sikandarpuri
Nazm tabaa-tabaa.ii 	/poets/nazm-tabaa-tabaaii
Nazmi Sikandrabadi 	/poets/nazmi-sikandrabadi
Nazneen Begum Naz 	/poets/nazneen-begum-naz
Neel Ahmed 	/poets/neel-ahmed
Neelma Sarwar 	/poets/neelma-sarwar
Neena Sahar 	/poets/neena-sahar
Neeraj Goswami 	/poets/neeraj-goswami
Nida Fazli 	/poets/nida-fazli
Nigar Azeem 	/poets/nigar-azeem
Nihal Lakhnavi 	/poets/nihal-lakhnavi
Nihal Rizvi 	/poets/nihal-rizvi
Nihal Sevharvi 	/poets/nihal-sevharvi
Nikhat Barelvi 	/poets/nikhat-barelvi
Nikhat Iftikhar 	/poets/nikhat-iftikhar
Nikhat Yasmeen Gul 	/poets/nikhat-yasmeen-gul
Nilofar Afzal 	/poets/nilofar-afzal
Nisar Itavi 	/poets/nisar-itavi
Nisar Kubra 	/poets/nisar-kubra
Nisar Mahmood Taseer 	/poets/nisar-mahmood-taseer
Nisar Nasik 	/poets/nisar-nasik
Nisar Tareen Jazib 	/poets/nisar-tareen-jazib
Nisar Turabi 	/poets/nisar-turabi
Nishant Shrivastava Nayab 	/poets/nishant-shrivastava-nayab
Nitin Nayab 	/poets/nitin-nayab
Nivesh Sahu 	/poets/nivesh-sahu
Niyaz Barelvi 	/poets/niyaz-barelvi
Niyaz Fatehpuri 	/poets/niyaz-fatehpuri
Niyaz Haidar 	/poets/niyaz-haidar
Niyaz Husain Lakhwera 	/poets/niyaz-husain-lakhwera
Niyaz Jairajpuri 	/poets/niyaz-jairajpuri
Nizam Rampuri 	/poets/nizam-rampuri
Nizamuddin Nizam 	/poets/nizamuddin-nizam
Nomaan Shauque 	/poets/nomaan-shauque
Noman Farooq 	/poets/noman-farooq
Noman Imam 	/poets/noman-imam
Nooh Narvi 	/poets/nooh-narvi
Noon Meem Danish 	/poets/noon-meem-danish
Noon Meem Rashid 	/poets/noon-meem-rashid
Noor Bijnauri 	/poets/noor-bijnauri
Noor Fatima Noor 	/poets/noor-fatima-noor
Noor Indori 	/poets/noor-indori
Noor Jahan Naz 	/poets/noor-jahan-naz
Noor Jahan Sarwat 	/poets/noor-jahan-sarwat
Noor Mohammad Noor 	/poets/noor-mohammad-noor
Noor Mohammad Yaas 	/poets/noor-mohammad-yaas
Noor muneeri 	/poets/noor-muneeri
Noor N Sahir 	/poets/noor-n-sahir
Noor Parkar 	/poets/noor-parkar
Noor Taqi Noor 	/poets/noor-taqi-noor
Noorain Talat Arooba 	/poets/noorain-talat-arooba
Noorul Ain Qaisar Qasmi 	/poets/noorul-ain-qaisar-qasmi
Noshi Gilani 	/poets/noshi-gilani
Nudrat Nawaz 	/poets/nudrat-nawaz
Nujumi Balyavi 	/poets/nujumi-balyavi
Nushur Wahidi 	/poets/nushur-wahidi
Nusrat Gwaliari 	/poets/nusrat-gwaliari
Nusrat Lakhnavi 	/poets/nusrat-lakhnavi
Nusrat Masood 	/poets/nusrat-masood
Nusrat Mehdi 	/poets/nusrat-mehdi
Nusrat Siddiqui 	/poets/nusrat-siddiqui
Nuzhat Nigar 	/poets/nuzhat-nigar
Obaid Haris 	/poets/obaid-haris
Obaid Siddiqi 	/poets/obaid-siddiqi
Obaidullah Aleem 	/poets/obaidullah-aleem
Obaidullah Khan Mubtala 	/poets/obaidullah-khan-mubtala
Obaidullah Siddiqui 	/poets/obaidullah-siddiqui
Obaidur Rahman 	/poets/obaidur-rahman
Obaidur Rahman Azmi 	/poets/obaidur-rahman-azmi
Om Krishn Rahat 	/poets/om-krishn-rahat
Om Parkash Bajaj 	/poets/om-parkash-bajaj
Om Prakash Laghar 	/poets/om-prakash-laghar
Osaama ameer 	/poets/osaama-ameer
Osama Khalid 	/poets/osama-khalid
Osama Zakir 	/poets/osama-zakir
Owais Ahmad Dauran 	/poets/owais-ahmad-dauran
Owaisul Hassan Khan 	/poets/owaisul-hassan-khan
Ozair Rahman 	/poets/ozair-rahman
Obaid Haris 	/poets/obaid-haris
Obaid Siddiqi 	/poets/obaid-siddiqi
Obaidullah Aleem 	/poets/obaidullah-aleem
Obaidullah Khan Mubtala 	/poets/obaidullah-khan-mubtala
Obaidullah Siddiqui 	/poets/obaidullah-siddiqui
Obaidur Rahman 	/poets/obaidur-rahman
Obaidur Rahman Azmi 	/poets/obaidur-rahman-azmi
Om Krishn Rahat 	/poets/om-krishn-rahat
Om Parkash Bajaj 	/poets/om-parkash-bajaj
Om Prakash Laghar 	/poets/om-prakash-laghar
Osaama ameer 	/poets/osaama-ameer
Osama Khalid 	/poets/osama-khalid
Osama Zakir 	/poets/osama-zakir
Owais Ahmad Dauran 	/poets/owais-ahmad-dauran
Owaisul Hassan Khan 	/poets/owaisul-hassan-khan
Ozair Rahman 	/poets/ozair-rahman
P P Srivastava Rind 	/poets/p-p-srivastava-rind
Paigham Aafaqi 	/poets/paigham-aafaqi
Pallav Mishra 	/poets/pallav-mishra
Pandit Chandr Bhan Barahman 	/poets/pandit-chandr-bhan-barahman
Pandit Daya Shankar Naseem lakhnavi 	/poets/pandit-daya-shankar-naseem-lakhnavi
Pandit Jagmohan Nath Raina Shauq 	/poets/pandit-jagmohan-nath-raina-shauq
Pandit Jawahar Nath Saqi 	/poets/pandit-jawahar-nath-saqi
Pankaj Sarhadi 	/poets/pankaj-sarhadi
Pankaj Subeer 	/authors/pankaj-subeer
Parkash Fikri 	/poets/parkash-fikri
Parkash Nath Parvez 	/poets/parkash-nath-parvez
Parkash Tiwari 	/poets/parkash-tiwari
Partav Rohila 	/poets/partav-rohila
Parveen Fana Syed 	/poets/parveen-fana-syed
Parveen Kumar Ashk 	/poets/parveen-kumar-ashk
Parveen Mirza 	/poets/parveen-mirza
Parveen Shakir 	/poets/parveen-shakir
Parveen Tahir 	/poets/parveen-tahir
Parveen Umm-e-Mushtaq 	/poets/parveen-umm-e-mushtaq
Parvez akhtar 	/poets/parvez-akhtar
Parvez Bazmi 	/poets/parvez-bazmi
Parvez Sahir 	/poets/parvez-sahir
Parvez Shahidi 	/poets/parvez-shahidi
Parvin Sheer 	/poets/parvin-sheer
Parvindar shokh 	/poets/parvindar-shokh
Parwaz Jalandhari 	/poets/parwaz-jalandhari
Pawan Kumar 	/poets/pawan-kumar
Payam Fatehpuri 	/poets/payam-fatehpuri
Peer Akram 	/poets/peer-akram
Peer Nasiruddin Shah Naseer 	/poets/peer-nasiruddin-shah-naseer
Peer Sher Mohammad Ajiz 	/poets/peer-sher-mohammad-ajiz
Perwaiz Shaharyar 	/poets/perwaiz-shaharyar
Pinhaan Sipher Ara Khatoon 	/poets/pinhaan-sipher-ara-khatoon
Pirzada Qasim 	/poets/pirzada-qasim
Piyare Lal Raunaq Dehlwi 	/poets/piyare-lal-raunaq-dehlwi
Poonam Yadav 	/poets/poonam-yadav
Prabudha Saurabh 	/poets/prabudha-saurabh
Prakhar Malviya Kanha 	/poets/prakhar-malviya-kanha
Pramod Sharma Asar 	/poets/pramod-sharma-asar
Pratap Somvanshi 	/poets/pratap-somvanshi
Prem Bhandari 	/poets/prem-bhandari
Prem Kumar Nazar 	/poets/prem-kumar-nazar
Prem Shankar Goila Farhat 	/poets/prem-shankar-goila-farhat
Prem Warbartani 	/poets/prem-warbartani-3
Premi Rumani 	/poets/premi-rumani
Preyas Hathi 'Raqim 	/poets/preyas-hathi-raqim
Pritpal Singh Betab 	/poets/pritpal-singh-betab
Priya Tabita 	/poets/priya-tabita
Priyadarshi Thakur Khayal 	/poets/priyadarshi-thakur-khayal
Puja Bhatia 	/poets/puja-bhatia
P P Srivastava Rind 	/poets/p-p-srivastava-rind
Paigham Aafaqi 	/poets/paigham-aafaqi
Pallav Mishra 	/poets/pallav-mishra
Pandit Chandr Bhan Barahman 	/poets/pandit-chandr-bhan-barahman
Pandit Daya Shankar Naseem lakhnavi 	/poets/pandit-daya-shankar-naseem-lakhnavi
Pandit Jagmohan Nath Raina Shauq 	/poets/pandit-jagmohan-nath-raina-shauq
Pandit Jawahar Nath Saqi 	/poets/pandit-jawahar-nath-saqi
Pankaj Sarhadi 	/poets/pankaj-sarhadi
Pankaj Subeer 	/authors/pankaj-subeer
Parkash Fikri 	/poets/parkash-fikri
Parkash Nath Parvez 	/poets/parkash-nath-parvez
Parkash Tiwari 	/poets/parkash-tiwari
Partav Rohila 	/poets/partav-rohila
Parveen Fana Syed 	/poets/parveen-fana-syed
Parveen Kumar Ashk 	/poets/parveen-kumar-ashk
Parveen Mirza 	/poets/parveen-mirza
Parveen Shakir 	/poets/parveen-shakir
Parveen Tahir 	/poets/parveen-tahir
Parveen Umm-e-Mushtaq 	/poets/parveen-umm-e-mushtaq
Parvez akhtar 	/poets/parvez-akhtar
Parvez Bazmi 	/poets/parvez-bazmi
Parvez Sahir 	/poets/parvez-sahir
Parvez Shahidi 	/poets/parvez-shahidi
Parvin Sheer 	/poets/parvin-sheer
Parvindar shokh 	/poets/parvindar-shokh
Parwaz Jalandhari 	/poets/parwaz-jalandhari
Pawan Kumar 	/poets/pawan-kumar
Payam Fatehpuri 	/poets/payam-fatehpuri
Peer Akram 	/poets/peer-akram
Peer Nasiruddin Shah Naseer 	/poets/peer-nasiruddin-shah-naseer
Peer Sher Mohammad Ajiz 	/poets/peer-sher-mohammad-ajiz
Perwaiz Shaharyar 	/poets/perwaiz-shaharyar
Pinhaan Sipher Ara Khatoon 	/poets/pinhaan-sipher-ara-khatoon
Pirzada Qasim 	/poets/pirzada-qasim
Piyare Lal Raunaq Dehlwi 	/poets/piyare-lal-raunaq-dehlwi
Poonam Yadav 	/poets/poonam-yadav
Prabudha Saurabh 	/poets/prabudha-saurabh
Prakhar Malviya Kanha 	/poets/prakhar-malviya-kanha
Pramod Sharma Asar 	/poets/pramod-sharma-asar
Pratap Somvanshi 	/poets/pratap-somvanshi
Prem Bhandari 	/poets/prem-bhandari
Prem Kumar Nazar 	/poets/prem-kumar-nazar
Prem Shankar Goila Farhat 	/poets/prem-shankar-goila-farhat
Prem Warbartani 	/poets/prem-warbartani-3
Premi Rumani 	/poets/premi-rumani
Preyas Hathi 'Raqim 	/poets/preyas-hathi-raqim
Pritpal Singh Betab 	/poets/pritpal-singh-betab
Priya Tabita 	/poets/priya-tabita
Priyadarshi Thakur Khayal 	/poets/priyadarshi-thakur-khayal
Puja Bhatia 	/poets/puja-bhatia
Pundit Amar Nath Hoshiyarpuri 	/poets/pundit-amar-nath-hoshiyarpuri
Purnam Allahabadi 	/poets/purnam-allahabadi
Purshottam Abbi Azer 	/poets/purshottam-abbi-azer
Qabil Ajmeri 	/poets/qabil-ajmeri
Qadr Bilgarami 	/poets/qadr-bilgarami
Qais Jalandhari 	/poets/qais-jalandhari
Qais Kakorvi 	/poets/qais-kakorvi
Qais Rampuri 	/poets/qais-rampuri
Qaisar Abbas 	/poets/qaisar-abbas
Qaisar hayat 	/poets/qaisar-hayat
Qaisar Nizami 	/poets/qaisar-nizami
Qaisar Qalandar 	/poets/qaisar-qalandar
Qaisar Shameem 	/poets/qaisar-shameem
Qaisar Siddiqi 	/poets/qaisar-siddiqi
Qaisar Umrao Tovi 	/poets/qaisar-umrao-tovi
Qaisar Usmani 	/poets/qaisar-usmani
Qaisar-ul-Jafri 	/poets/qaisar-ul-jafri
Qaleel Jhansvi 	/poets/qaleel-jhansvi
Qamar Abbas Qamar 	/poets/qamar-abbas-qamar
Qamar Badarpuri 	/poets/qamar-badarpuri
Qamar Hashmi 	/poets/qamar-hashmi
Qamar Iqbal 	/poets/qamar-iqbal
Qamar Jalalabadi 	/poets/qamar-jalalabadi
Qamar Jalalvi 	/poets/qamar-jalalvi
Qamar Jameel 	/poets/qamar-jameel
Qamar Moradabadi 	/poets/qamar-moradabadi
Qamar Naqvi 	/poets/qamar-naqvi
Qamar Raees 	/poets/qamar-raees
Qamar Raza Shahzad 	/poets/qamar-raza-shahzad
Qamar Sanbhali 	/poets/qamar-sanbhali
Qamar Siddiqi 	/poets/qamar-siddiqi
Qamar-un-Nisa Qamar 	/poets/qamar-un-nisa-qamar
Qamruddeen Khurshid 	/poets/qamruddeen-khurshid
Qamruddin 	/poets/qamruddin
Qasid Aziz 	/poets/qasid-aziz
Qasim Ali Khan Afridi 	/poets/qasim-ali-khan-afridi
Qasim Jalal 	/poets/qasim-jalal
Qasim Niyazi 	/poets/qasim-niyazi
Qasim Yaqub 	/poets/qasim-yaqub
Qateel Shifai 	/poets/qateel-shifai
Qaus Siddiqui 	/poets/qaus-siddiqui
Qayem Chandpuri 	/poets/qayem-chandpuri
Qayem Naqvi 	/poets/qayem-naqvi
Qayoom Shakri 	/poets/qayoom-shakri
Qayyum Nazar 	/poets/qayyum-nazar
Qayyum Tahir 	/poets/qayyum-tahir
Qazalbash Khan Ummeed 	/poets/qazalbash-khan-ummeed
Qazi Ansar 	/poets/qazi-ansar
Qazi Ehtisham Bachhrauni 	/poets/qazi-ehtisham-bachhrauni
Qazi Ejaz Mehwar 	/poets/qazi-ejaz-mehwar
Qazi Habiburrahman 	/poets/qazi-habiburrahman
Qazi Hasan Raza 	/poets/qazi-hasan-raza
Qazi Mahmud Behri 	/poets/qazi-mahmud-behri
Qabil Ajmeri 	/poets/qabil-ajmeri
Qadr Bilgarami 	/poets/qadr-bilgarami
Qais Jalandhari 	/poets/qais-jalandhari
Qais Kakorvi 	/poets/qais-kakorvi
Qais Rampuri 	/poets/qais-rampuri
Qaisar Abbas 	/poets/qaisar-abbas
Qaisar hayat 	/poets/qaisar-hayat
Qaisar Nizami 	/poets/qaisar-nizami
Qaisar Qalandar 	/poets/qaisar-qalandar
Qaisar Shameem 	/poets/qaisar-shameem
Qaisar Siddiqi 	/poets/qaisar-siddiqi
Qaisar Umrao Tovi 	/poets/qaisar-umrao-tovi
Qaisar Usmani 	/poets/qaisar-usmani
Qaisar-ul-Jafri 	/poets/qaisar-ul-jafri
Qaleel Jhansvi 	/poets/qaleel-jhansvi
Qamar Abbas Qamar 	/poets/qamar-abbas-qamar
Qamar Badarpuri 	/poets/qamar-badarpuri
Qamar Hashmi 	/poets/qamar-hashmi
Qamar Iqbal 	/poets/qamar-iqbal
Qamar Jalalabadi 	/poets/qamar-jalalabadi
Qamar Jalalvi 	/poets/qamar-jalalvi
Qamar Jameel 	/poets/qamar-jameel
Qamar Moradabadi 	/poets/qamar-moradabadi
Qamar Naqvi 	/poets/qamar-naqvi
Qamar Raees 	/poets/qamar-raees
Qamar Raza Shahzad 	/poets/qamar-raza-shahzad
Qamar Sanbhali 	/poets/qamar-sanbhali
Qamar Siddiqi 	/poets/qamar-siddiqi
Qamar-un-Nisa Qamar 	/poets/qamar-un-nisa-qamar
Qamruddeen Khurshid 	/poets/qamruddeen-khurshid
Qamruddin 	/poets/qamruddin
Qasid Aziz 	/poets/qasid-aziz
Qasim Ali Khan Afridi 	/poets/qasim-ali-khan-afridi
Qasim Jalal 	/poets/qasim-jalal
Qasim Niyazi 	/poets/qasim-niyazi
Qasim Yaqub 	/poets/qasim-yaqub
Qateel Shifai 	/poets/qateel-shifai
Qaus Siddiqui 	/poets/qaus-siddiqui
Qayem Chandpuri 	/poets/qayem-chandpuri
Qayem Naqvi 	/poets/qayem-naqvi
Qayoom Shakri 	/poets/qayoom-shakri
Qayyum Nazar 	/poets/qayyum-nazar
Qayyum Tahir 	/poets/qayyum-tahir
Qazalbash Khan Ummeed 	/poets/qazalbash-khan-ummeed
Qazi Ansar 	/poets/qazi-ansar
Qazi Ehtisham Bachhrauni 	/poets/qazi-ehtisham-bachhrauni
Qazi Ejaz Mehwar 	/poets/qazi-ejaz-mehwar
Qazi Habiburrahman 	/poets/qazi-habiburrahman
Qazi Hasan Raza 	/poets/qazi-hasan-raza
Qazi Mahmud Behri 	/poets/qazi-mahmud-behri
Qazi Saleem 	/poets/qazi-saleem
Quaiser Khalid 	/poets/quaiser-khalid
Quli Qutub Shah 	/poets/quli-qutub-shah
Qurban Aatish 	/poets/qurban-aatish
Qurban Ali Salik Beg 	/poets/qurban-ali-salik-beg
Qurbi Velori 	/poets/qurbi-velori
Raabia Pinhan 	/poets/raabia-pinhan
Raaz Allahabadi 	/poets/raaz-allahabadi
Raaz Layalpuri 	/poets/raaz-layalpuri
Raaz Muradabadi 	/poets/raaz-muradabadi
Raaz Yazdani 	/poets/raaz-yazdani
Rab Nawaz Mael 	/poets/rab-nawaz-mael
Rabab Rashidi 	/poets/rabab-rashidi
Rabia Fakhri 	/poets/rabia-fakhri
Radhe Shiyam Rastogi Ahqar 	/poets/radhe-shiyam-rastogi-ahqar
Raees Akhtar 	/poets/raees-akhtar
Raees Ansari 	/poets/raees-ansari
Raees Baghi 	/poets/raees-baghi
Raees Faraz 	/poets/raees-faraz
Raees minai 	/poets/raees-minai
Raees Narvi 	/poets/raees-narvi
Raees Niyazi 	/poets/raees-niyazi
Raees Rampuri 	/poets/raees-rampuri
Raees Warsi 	/poets/raees-warsi
Raeesuddin Fareedi 	/poets/raeesuddin-fareedi
Raeesuddin Raees 	/poets/raeesuddin-raees
Raeesuddin Tahoor Jafri 	/poets/raeesuddin-tahoor-jafri
Rafat Shameem 	/poets/rafat-shameem
Rafi Raza 	/poets/rafi-raza
Rafia Shabnam Abidi 	/poets/rafia-shabnam-abidi
Rafiq Khawar Jaskani 	/poets/rafiq-khawar-jaskani
Rafiq Raaz 	/poets/rafiq-raaz
Rafiq Sandelvi 	/poets/rafiq-sandelvi
Rafique Khayal 	/poets/rafique-khayal
Rafiquzzaman 	/poets/rafiquzzaman
Rafiullah Mian 	/poets/rafiullah-mian
Raghib Akhtar 	/poets/raghib-akhtar
Raghib Badayuni 	/poets/raghib-badayuni
Raghib Muradabadi 	/poets/raghib-muradabadi
Raghunandan Sharma 	/poets/raghunandan-sharma
Raghunath Sahai 	/poets/raghunath-sahai
Ragib Shakeb 	/poets/ragib-shakeb
Rahat hasan 	/poets/rahat-hasan
Rahat Indori 	/poets/rahat-indori
Rahat Naseem Malik 	/poets/rahat-naseem-malik
Rahat Sarhadi 	/poets/rahat-sarhadi
Rahber Jaunpuri 	/poets/rahber-jaunpuri
Raheel Farooq 	/poets/raheel-farooq
Rahi Fidai 	/poets/rahi-fidai
Rahi Masoom Raza 	/poets/rahi-masoom-raza
Rahi Quraishi 	/poets/rahi-quraishi
Rahi Shahabi 	/poets/rahi-shahabi
Rahil Bukhari 	/poets/rahil-bukhari
Rahman Hafeez 	/poets/rahman-hafeez
Rahman Jami 	/poets/rahman-jami
Rahman Khawar 	/poets/rahman-khawar
Raabia Pinhan 	/poets/raabia-pinhan
Raaz Allahabadi 	/poets/raaz-allahabadi
Raaz Layalpuri 	/poets/raaz-layalpuri
Raaz Muradabadi 	/poets/raaz-muradabadi
Raaz Yazdani 	/poets/raaz-yazdani
Rab Nawaz Mael 	/poets/rab-nawaz-mael
Rabab Rashidi 	/poets/rabab-rashidi
Rabia Fakhri 	/poets/rabia-fakhri
Radhe Shiyam Rastogi Ahqar 	/poets/radhe-shiyam-rastogi-ahqar
Raees Akhtar 	/poets/raees-akhtar
Raees Ansari 	/poets/raees-ansari
Raees Baghi 	/poets/raees-baghi
Raees Faraz 	/poets/raees-faraz
Raees minai 	/poets/raees-minai
Raees Narvi 	/poets/raees-narvi
Raees Niyazi 	/poets/raees-niyazi
Raees Rampuri 	/poets/raees-rampuri
Raees Warsi 	/poets/raees-warsi
Raeesuddin Fareedi 	/poets/raeesuddin-fareedi
Raeesuddin Raees 	/poets/raeesuddin-raees
Raeesuddin Tahoor Jafri 	/poets/raeesuddin-tahoor-jafri
Rafat Shameem 	/poets/rafat-shameem
Rafi Raza 	/poets/rafi-raza
Rafia Shabnam Abidi 	/poets/rafia-shabnam-abidi
Rafiq Khawar Jaskani 	/poets/rafiq-khawar-jaskani
Rafiq Raaz 	/poets/rafiq-raaz
Rafiq Sandelvi 	/poets/rafiq-sandelvi
Rafique Khayal 	/poets/rafique-khayal
Rafiquzzaman 	/poets/rafiquzzaman
Rafiullah Mian 	/poets/rafiullah-mian
Raghib Akhtar 	/poets/raghib-akhtar
Raghib Badayuni 	/poets/raghib-badayuni
Raghib Muradabadi 	/poets/raghib-muradabadi
Raghunandan Sharma 	/poets/raghunandan-sharma
Raghunath Sahai 	/poets/raghunath-sahai
Ragib Shakeb 	/poets/ragib-shakeb
Rahat hasan 	/poets/rahat-hasan
Rahat Indori 	/poets/rahat-indori
Rahat Naseem Malik 	/poets/rahat-naseem-malik
Rahat Sarhadi 	/poets/rahat-sarhadi
Rahber Jaunpuri 	/poets/rahber-jaunpuri
Raheel Farooq 	/poets/raheel-farooq
Rahi Fidai 	/poets/rahi-fidai
Rahi Masoom Raza 	/poets/rahi-masoom-raza
Rahi Quraishi 	/poets/rahi-quraishi
Rahi Shahabi 	/poets/rahi-shahabi
Rahil Bukhari 	/poets/rahil-bukhari
Rahman Hafeez 	/poets/rahman-hafeez
Rahman Jami 	/poets/rahman-jami
Rahman Khawar 	/poets/rahman-khawar
Rahmat Amrohvi 	/poets/rahmat-amrohvi
Rahmat Ilahi Barq Aazmi 	/poets/rahmat-ilahi-barq-aazmi
Rahmat Qarni 	/poets/rahmat-qarni
Rahul Jha 	/poets/rahul-jha
Rais Amrohvi 	/poets/rais-amrohvi
Rais Farogh 	/poets/rais-farogh
Rais Siddiqui 	/poets/rais-siddiqui
Raj Bahadur Saxena Auj 	/poets/raj-bahadur-saxena-auj
Raj Kaushik 	/poets/raj-kaushik
Raj Kheti 	/poets/raj-kheti
Raj Kumar Qais 	/poets/raj-kumar-qais
Raj Kumar Soori Nadeem 	/poets/raj-kumar-soori-nadeem
Raj Narayan Raaz 	/poets/raj-narayan-raaz
Rajab Ali Beg Suroor 	/poets/rajab-ali-beg-suroor
Rajendra Kalkal 	/poets/rajendra-kalkal
Rajendra Nath Rahbar 	/poets/rajendra-nath-rahbar
Rajesh Reddy 	/poets/rajesh-reddy
Rajinder Krishan 	/poets/rajinder-krishan
Rajinder Manchanda Bani 	/poets/rajinder-manchanda-bani
Rajneesh Sachan 	/poets/rajneesh-sachan
Rakesh Rahi 	/poets/rakesh-rahi
Rakhshan Hashmi 	/poets/rakhshan-hashmi
Rakhshanda Naved 	/poets/rakhshanda-naved
Rakib Mukhtar 	/poets/rakib-mukhtar
Ram Awtar Gupta Muztar 	/poets/ram-awtar-gupta-muztar
Ram Daas 	/poets/ram-daas
Ram Krishn Muztar 	/poets/ram-krishn-muztar
Ram Nath Aseer 	/poets/ram-nath-aseer
Ram Parkash Rahi 	/poets/ram-parkash-rahi
Ram Riyaz 	/poets/ram-riyaz
Ramesh Kanwal 	/poets/ramesh-kanwal
Ramz Afaqi 	/poets/ramz-afaqi
Ramz Azimabadi 	/poets/ramz-azimabadi
Ramzan Ali Sahar 	/poets/ramzan-ali-sahar
Ramzi Asim 	/poets/ramzi-asim
Rana Akbarabadi 	/poets/rana-akbarabadi
Rana Amir Liyaqat 	/poets/rana-amir-liyaqat
Rana Gannauri 	/poets/rana-gannauri
Rana Saeed Doshi 	/poets/rana-saeed-doshi
Rana Sahri 	/poets/rana-sahri
Rangin Saadat Yaar Khan  	/poets/rangin-saadat-yaar-khan
Ranjoor Azimabadi 	/poets/ranjoor-azimabadi
Raoof Ameer 	/poets/raoof-ameer
Raqim Dehlavi 	/poets/raqim-dehlavi
Rasa Chughtai 	/poets/rasa-chughtai
Rasa Rampuri 	/poets/rasa-rampuri
Rasheed Afroz 	/poets/rasheed-afroz
Rasheed Ayan 	/poets/rasheed-ayan
Rasheed Ejaz 	/poets/rasheed-ejaz
Rasheed Javed 	/poets/rasheed-javed
Rasheed Kamil 	/poets/rasheed-kamil
Rasheed Kausar Farooqi 	/poets/rasheed-kausar-farooqi
Rasheed lakhnavi 	/poets/rasheed-lakhnavi
Rasheed Nisar 	/poets/rasheed-nisar
Rasheed Qaisrani 	/poets/rasheed-qaisrani
Rasheed Rampuri 	/poets/rasheed-rampuri
Rasheed Usmani 	/poets/rasheed-usmani
Rasheeda Maheen Malik 	/poets/rasheeda-maheen-malik
Rasheeda Saleem Seemin 	/poets/rasheeda-saleem-seemin
Rasheeduzzafar 	/poets/rasheeduzzafar
Rashid Aazar 	/poets/rashid-aazar
Rashid Ameen 	/poets/rashid-ameen
Rashid Anwar Rashid 	/poets/rashid-anwar-rashid
Rashid Banarasi 	/poets/rashid-banarasi
Rashid Fazli 	/poets/rashid-fazli
Rashid Hamidi 	/poets/rashid-hamidi
Rashid Hasan Rana 	/poets/rashid-hasan-rana
Rashid Imkan 	/poets/rashid-imkan
Rashid Jamaal Farooqi 	/poets/rashid-jamaal-farooqi
Rashid Kamil 	/poets/rashid-kamil
Rashid Mateen 	/poets/rashid-mateen
Rashid Mufti 	/poets/rashid-mufti
Rashid Mura 	/poets/rashid-mura
Rashid Noor 	/poets/rashid-noor
Rashid Qayyum Ansar 	/poets/rashid-qayyum-ansar
Rashid Rahi 	/poets/rashid-rahi
Rashid Shahjahanpuri 	/poets/rashid-shahjahanpuri
Rashid Taraz 	/poets/rashid-taraz
Rashk Khaleeli 	/poets/rashk-khaleeli
Rashmi Bhardwaj 	/poets/rashmi-bhardwaj
Rashmi Saba 	/poets/rashmi-saba
Rasikh Azimabadi 	/poets/rasikh-azimabadi
Rasikh Farani 	/poets/rasikh-farani
Rasikh Irfani 	/poets/rasikh-irfani
Rasool Jahan Begam Makhfi Badayuni 	/poets/rasool-jahan-begam-makhfi-badayuni
Rasool Saqi 	/poets/rasool-saqi
Ratan Nath Sarshar 	/poets/ratan-nath-sarshar
Ratan Pandorwi 	/poets/ratan-pandorwi
Rauf Khair 	/poets/rauf-khair
Rauf Khalish 	/poets/rauf-khalish
Rauf Raza 	/poets/rauf-raza
Rauf Sadiq 	/poets/rauf-sadiq
Rauf Yasin Jalali 	/poets/rauf-yasin-jalali
Raunaq Deccani 	/poets/raunaq-deccani
Raunaq Naeem 	/poets/raunaq-naeem
Raunaq Raza 	/poets/raunaq-raza
Raunaq Tonkvi 	/poets/raunaq-tonkvi
Raushan Laal Raushan 	/poets/raushan-laal-raushan
Raushan Naginvi 	/poets/raushan-naginvi
Ravi Kumar 	/poets/ravi-kumar
Ravish Nadeem 	/poets/ravish-nadeem
Ravish Siddiqi 	/poets/ravish-siddiqi
Raza Amrohvi 	/poets/raza-amrohvi
Raza Ashk 	/poets/raza-ashk
Raza Azimabadi 	/poets/raza-azimabadi
Raza Hamdani 	/poets/raza-hamdani
Raza Jaunpuri 	/poets/raza-jaunpuri
Raza Lakhnavi 	/poets/raza-lakhnavi
Raza Mauranvi 	/poets/raza-mauranvi
Raza Muradabadi 	/poets/raza-muradabadi
Raza Naqvi Vahi 	/poets/raza-naqvi-vahi
Razi Akhtar Shauq 	/poets/razi-akhtar-shauq
Razi Mujtaba 	/poets/razi-mujtaba
Razi Raziuddin 	/poets/razi-raziuddin
Razi Tirmizi 	/poets/razi-tirmizi
Razia Halim Jang 	/poets/razia-halim-jang
Raziq Ansari 	/poets/raziq-ansari
Raziya Faseeh Ahmad 	/poets/raziya-faseeh-ahmad
Razzaq Aadil 	/poets/razzaq-aadil
Razzaq Afsar 	/poets/razzaq-afsar
Razzaq Arshad 	/poets/razzaq-arshad
Rehan Alvi 	/poets/rehan-alvi
Rehana Qamar 	/poets/rehana-qamar
Rehana Roohi 	/poets/rehana-roohi
Rehman Faris 	/poets/rehman-faris
Renu Nayyar 	/poets/renu-nayyar
Renu Verma 	/poets/renu-verma
Riaz Hans 	/poets/riaz-hans
Riaz Latif 	/poets/riaz-latif
Riaz Majeed 	/poets/riaz-majeed
Rifat Abbas 	/poets/rifat-abbas
Rifat Al-Husaini 	/poets/rifat-al-husaini
Rifat Naheed 	/poets/rifat-naheed
Rifat Sarosh 	/poets/rifat-sarosh
Rifat Sethi 	/poets/rifat-sethi
Rifat Sultan 	/poets/rifat-sultan
Rifat Zamani Begum Ismat 	/poets/rifat-zamani-begum-ismat
Rifat-ul-Qasmi 	/poets/rifat-ul-qasmi
Rind Lakhnavi 	/poets/rind-lakhnavi
Rind Saghari 	/poets/rind-saghari
Rishi Patialvi 	/poets/rishi-patialvi
Riyasat Ali Taj 	/poets/riyasat-ali-taj
Riyaz Khairabadi 	/poets/riyaz-khairabadi
Riyaz Saghar 	/poets/riyaz-saghar
Riyazat Ali Shaiq 	/poets/riyazat-ali-shaiq
Rizwanullah 	/poets/rizwanullah
Rizwanur Raza Rizwan 	/poets/rizwanur-raza-rizwan
Robeena Faisal 	/poets/robeena-faisal
Rohit Soni 'Tabish' 	/poets/rohit-soni-tabish
Roohi Kanjahi 	/poets/roohi-kanjahi
Roop Sagar 	/poets/roop-sagar
Roy Sarb Sukh Diwana 	/poets/roy-sarb-sukh-diwana
Rukhsana Noor 	/poets/rukhsana-noor
Rumana Rumi 	/poets/rumana-rumi
S A Mehdi 	/poets/s-a-mehdi
Saadat Bandvi 	/poets/saadat-bandvi
Saadat Saeed 	/poets/saadat-saeed
Saadullah Kaleem 	/poets/saadullah-kaleem
Saadullah Shah 	/poets/saadullah-shah
Saail Dehlvi 	/poets/saail-dehlvi
Saba Afghani 	/poets/saba-afghani
Saba Akbarabadi 	/poets/saba-akbarabadi
Saba Akhtar 	/poets/saba-akhtar
Saba Ikram 	/poets/saba-ikram
Saba Jayasi 	/poets/saba-jayasi
Saba Naqvi 	/poets/saba-naqvi
Saba Nusrat 	/poets/saba-nusrat
Sabeela Inam Siddiqui 	/poets/sabeela-inam-siddiqui
Sabiha Saba 	/poets/sabiha-saba
Sabiha Saba 	/poets/sabiha-saba-1
Sabir 	/poets/sabir
Sabir Adeeb  	/poets/sabir-adeeb
Sabir Afaqi 	/poets/sabir-afaqi
Sabir Badr jaafrii 	/poets/sabir-badr-jaafrii
Sabir Dutt 	/poets/sabir-dutt
Sabir Raza 	/poets/sabir-raza
Sabir Shah Sabir 	/poets/sabir-shah-sabir
Sabir Waseem 	/poets/sabir-waseem
Sabir Zafar 	/poets/sabir-zafar
Sabir Zahid 	/poets/sabir-zahid
Sachin Shalini 	/poets/sachin-shalini
Sada Ambalvi 	/poets/sada-ambalvi
Sadaf Jafri 	/poets/sadaf-jafri
Sadiq 	/poets/sadiq
Sadiqa Fatimi 	/poets/sadiqa-fatimi
Sadique Indori 	/poets/sadique-indori
Sadique Naseem 	/poets/sadique-naseem
Sadiya Roshan Siddiqui 	/poets/sadiya-roshan-siddiqui
Sadiya Safdar Saadi 	/poets/sadiya-safdar-saadi
Saeed Aasim 	/poets/saeed-aasim
Saeed Ahmad 	/poets/saeed-ahmad
Saeed Ahmad Akhtar 	/poets/saeed-ahmad-akhtar
Saeed Akhtar 	/poets/saeed-akhtar
Saeed Arifi 	/poets/saeed-arifi
Saeed Khan 	/poets/saeed-khan
Saeed Naqvi 	/poets/saeed-naqvi
saeed Qais 	/poets/saeed-qais
Saeed Rahi 	/poets/saeed-rahi
Saeed Shabab 	/poets/saeed-shabab
Saeed Shariq 	/poets/saeed-shariq
Saeeda Jahan Makhfi 	/poets/saeeda-jahan-makhfi
Saeeduddin 	/poets/saeeduddin
Saeed-ul-Zafar Chughtai 	/poets/saeed-ul-zafar-chughtai
Saeeduzzamaan Abbasi 	/poets/saeeduzzamaan-abbasi
S A Mehdi 	/poets/s-a-mehdi
Saadat Bandvi 	/poets/saadat-bandvi
Saadat Saeed 	/poets/saadat-saeed
Saadullah Kaleem 	/poets/saadullah-kaleem
Saadullah Shah 	/poets/saadullah-shah
Saail Dehlvi 	/poets/saail-dehlvi
Saba Afghani 	/poets/saba-afghani
Saba Akbarabadi 	/poets/saba-akbarabadi
Saba Akhtar 	/poets/saba-akhtar
Saba Ikram 	/poets/saba-ikram
Saba Jayasi 	/poets/saba-jayasi
Saba Naqvi 	/poets/saba-naqvi
Saba Nusrat 	/poets/saba-nusrat
Sabeela Inam Siddiqui 	/poets/sabeela-inam-siddiqui
Sabiha Saba 	/poets/sabiha-saba
Sabiha Saba 	/poets/sabiha-saba-1
Sabir 	/poets/sabir
Sabir Adeeb  	/poets/sabir-adeeb
Sabir Afaqi 	/poets/sabir-afaqi
Sabir Badr jaafrii 	/poets/sabir-badr-jaafrii
Sabir Dutt 	/poets/sabir-dutt
Sabir Raza 	/poets/sabir-raza
Sabir Shah Sabir 	/poets/sabir-shah-sabir
Sabir Waseem 	/poets/sabir-waseem
Sabir Zafar 	/poets/sabir-zafar
Sabir Zahid 	/poets/sabir-zahid
Sachin Shalini 	/poets/sachin-shalini
Sada Ambalvi 	/poets/sada-ambalvi
Sadaf Jafri 	/poets/sadaf-jafri
Sadiq 	/poets/sadiq
Sadiqa Fatimi 	/poets/sadiqa-fatimi
Sadique Indori 	/poets/sadique-indori
Sadique Naseem 	/poets/sadique-naseem
Sadiya Roshan Siddiqui 	/poets/sadiya-roshan-siddiqui
Sadiya Safdar Saadi 	/poets/sadiya-safdar-saadi
Saeed Aasim 	/poets/saeed-aasim
Saeed Ahmad 	/poets/saeed-ahmad
Saeed Ahmad Akhtar 	/poets/saeed-ahmad-akhtar
Saeed Akhtar 	/poets/saeed-akhtar
Saeed Arifi 	/poets/saeed-arifi
Saeed Khan 	/poets/saeed-khan
Saeed Naqvi 	/poets/saeed-naqvi
saeed Qais 	/poets/saeed-qais
Saeed Rahi 	/poets/saeed-rahi
Saeed Shabab 	/poets/saeed-shabab
Saeed Shariq 	/poets/saeed-shariq
Saeeda Jahan Makhfi 	/poets/saeeda-jahan-makhfi
Saeeduddin 	/poets/saeeduddin
Saeed-ul-Zafar Chughtai 	/poets/saeed-ul-zafar-chughtai
Saeeduzzamaan Abbasi 	/poets/saeeduzzamaan-abbasi
Safdar Khursheed 	/poets/safdar-khursheed
Safdar Meer 	/poets/safdar-meer
Safdar Raza Safi 	/poets/safdar-raza-safi
Safdar Saleem Sial 	/poets/safdar-saleem-sial
Safdar Siddiq Razi 	/poets/safdar-siddiq-razi
Safeer Kakorvi 	/poets/safeer-kakorvi
Safi Aurangabadi 	/poets/safi-aurangabadi
Safi Lakhnavi 	/poets/safi-lakhnavi
Safiya Arib 	/poets/safiya-arib
Safiya Shamim 	/poets/safiya-shamim
Sagar Jalalabadi 	/poets/sagar-jalalabadi
Saghar Azmi 	/poets/saghar-azmi
Saghar Khayyami 	/poets/saghar-khayyami
Saghar Mehdi 	/poets/saghar-mehdi
Saghar Nizami 	/poets/saghar-nizami
Saghar Siddiqui 	/poets/saghar-siddiqui
Sagheer Alam 	/poets/sagheer-alam
Sagheer Ali Murawat 	/poets/sagheer-ali-murawat
Sagheer Malal 	/poets/sagheer-malal
Saghir Ahmad Saghir Ahsani 	/poets/saghir-ahmad-saghir-ahsani
Saghir Ahmad Sufi 	/poets/saghir-ahmad-sufi
Sahab Qazalbash 	/poets/sahab-qazalbash
Sahar Ansari 	/poets/sahar-ansari
Sahar Mahmood 	/poets/sahar-mahmood
Sahba Akhtar 	/poets/sahba-akhtar
Sahba lakhnavi 	/poets/sahba-lakhnavi
Sahba Waheed 	/poets/sahba-waheed
Sahiba Sheheryar 	/poets/sahiba-sheheryar
Sahil Ahmad 	/poets/sahil-ahmad
Sahir Bhopali 	/poets/sahir-bhopali
Sahir dehlavi 	/poets/sahir-dehlavi
Sahir Hoshiyarpuri 	/poets/sahir-hoshiyarpuri
Sahir lakhnavi 	/poets/sahir-lakhnavi
Sahir Ludhianvi 	/poets/sahir-ludhianvi
Sahir Shevi 	/poets/sahir-shevi
Sahir Siyalkoti 	/poets/sahir-siyalkoti
Saib Asmi 	/poets/saib-asmi
Said Iqbal Saadi 	/poets/said-iqbal-saadi
Saif Ali 	/poets/saif-ali
Saif Bijnori 	/poets/saif-bijnori
Saif Sahsarami 	/poets/saif-sahsarami
Saif Zulfi 	/poets/saif-zulfi
Saifi Premi 	/poets/saifi-premi
Saifi sironji 	/poets/saifi-sironji
Saifuddin Saif 	/poets/saifuddin-saif
Sailani Sevte 	/poets/sailani-sevte
Saim Ji 	/poets/saim-ji
Saima Aftab 	/poets/saima-aftab
Saima Esma 	/poets/saima-esma
Saima Jabeen Mahak 	/poets/saima-jabeen-mahak
Saima Khairi 	/poets/saima-khairi
Sajid Amjad 	/poets/sajid-amjad
Sajid Asar 	/poets/sajid-asar
Sajid Hameed 	/poets/sajid-hameed
Sajid Hashmi 	/poets/sajid-hashmi
Sajid Premi 	/poets/sajid-premi
Sajid Siddiqi lakhnavi 	/poets/sajid-siddiqi-lakhnavi
Sajida Zaidi 	/poets/sajida-zaidi
Sajjad Babar 	/poets/sajjad-babar
Sajjad Baluch 	/poets/sajjad-baluch
Sajjad Baqar Rizvi 	/poets/sajjad-baqar-rizvi
Sajjad Shamsi 	/poets/sajjad-shamsi
Sajjad Syed 	/poets/sajjad-syed
Sajjad Zaheer 	/poets/sajjad-zaheer
Sakhawat Shameem 	/poets/sakhawat-shameem
Sakhi Lakhnvi 	/poets/sakhi-lakhnvi
Salahuddin Mahmood  	/poets/salahuddin-mahmood
Salahuddin Mohammad 	/poets/salahuddin-mohammad
Salahuddin Nadeem 	/poets/salahuddin-nadeem
Salahuddin Nayyar 	/poets/salahuddin-nayyar
Salahuddin Parvez 	/poets/salahuddin-parvez
Salam Machhli shahri 	/poets/salam-machhli-shahri
Salam Sandelvi 	/poets/salam-sandelvi
Saleem Ahmed 	/poets/saleem-ahmed
Saleem Ansari 	/poets/saleem-ansari
Saleem Betab 	/poets/saleem-betab
Saleem Faraz 	/poets/saleem-faraz
Saleem Fauz 	/poets/saleem-fauz
Saleem Figar 	/poets/saleem-figar
Saleem Kashir 	/poets/saleem-kashir
Saleem Kausar 	/poets/saleem-kausar
Saleem Muhiuddin 	/poets/saleem-muhiuddin
Saleem Raza Rewa 	/poets/saleem-raza-rewa
Saleem Sarfaraz 	/poets/saleem-sarfaraz
Saleem Shahid 	/poets/saleem-shahid
Saleem Shahzad 	/poets/saleem-shahzad
Saleem Shirazi 	/poets/saleem-shirazi
Saleem Siddiqui 	/poets/saleem-siddiqui
Saleem-ur-Rahman 	/poets/saleem-ur-rahman
Salik Dehlvi 	/poets/salik-dehlvi
Salik Lakhnavi 	/poets/salik-lakhnavi
Salim Sagar 	/poets/salim-sagar
Salim Saleem 	/poets/salim-saleem
Salim Shuja Ansari 	/poets/salim-shuja-ansari
Salma shaheen 	/poets/salma-shaheen-1
Salman Akhtar 	/poets/salman-akhtar
Salman Ansari 	/poets/salman-ansari
Salman Saeed 	/poets/salman-saeed
Salman Sarwat 	/poets/salman-sarwat
Salman Siddiqui 	/poets/salman-siddiqui
Salman Zafar 	/poets/salman-zafar
Samad Ansari 	/poets/samad-ansari
Sameena Raja 	/poets/sameena-raja
Sameer Kabeer 	/poets/sameer-kabeer
Sanaullah Firaq  	/poets/sanaullah-firaq
Sanaullah Zaheer 	/poets/sanaullah-zaheer
Sandeep Koul Nadim 	/poets/sandeep-koul-nadim
Sanjay Mishra Shauq 	/poets/sanjay-mishra-shauq
Sanjiv Arya 	/poets/sanjiv-arya
Santosh khirvadkar 	/poets/santosh-khirvadkar
Saqi Amrohvi 	/poets/saqi-amrohvi
Saqi Faruqi 	/poets/saqi-faruqi
Saqib Kanpuri 	/poets/saqib-kanpuri
Saqib Lakhnavi 	/poets/saqib-lakhnavi
Saqib Razmi 	/poets/saqib-razmi
Sara Shagufta 	/poets/sara-shagufta
Saraswati Saran Kaif 	/poets/saraswati-saran-kaif
Sardar Anjum 	/poets/sardar-anjum
Sardar Asif 	/poets/sardar-asif
Sardar Ayagh 	/poets/sardar-ayagh
Sardar Genda Singh Mashriqi 	/poets/sardar-genda-singh-mashriqi
Sardar Panchhi 	/poets/sardar-panchhi
Sardar Saleem 	/poets/sardar-saleem
Sardar Soz 	/poets/sardar-soz
Sareer Kabiri 	/poets/sareer-kabiri
Sarfaraz Abad 	/poets/sarfaraz-abad
Sarfaraz Amir 	/poets/sarfaraz-amir
Sarfaraz Shahid 	/poets/sarfaraz-shahid
Sarfaraz Syed 	/poets/sarfaraz-syed
Sarfraz Arish 	/poets/sarfraz-arish
Sarfraz Danish 	/poets/sarfraz-danish
Sarfraz Khalid 	/poets/sarfraz-khalid
Sarfraz Nawaz 	/poets/sarfraz-nawaz
Sarfraz Zahid 	/poets/sarfraz-zahid
Sarmad Sahbai 	/poets/sarmad-sahbai
Sarshaar buland Shahri 	/poets/sarshaar-buland-shahri
Sarshar Sailani 	/poets/sarshar-sailani
Sarshar Siddiqui 	/poets/sarshar-siddiqui
Sartaj Alam Abidi 	/poets/sartaj-alam-abidi
Sarvar Usmani 	/poets/sarvar-usmani
Sarvat Husain 	/poets/sarvat-husain
Sarwar Alam Raz 	/poets/sarwar-alam-raz
Sarwar Arman 	/poets/sarwar-arman
Sarwar Majaz 	/poets/sarwar-majaz
Sarwar nepali 	/poets/sarwar-nepali
Sarwat Muhiuddin 	/poets/sarwat-muhiuddin
Sarwat Mukhtar 	/poets/sarwat-mukhtar
Sarwat Zehra 	/poets/sarwat-zehra
Sattar Syed 	/poets/sattar-syed
Satya Nand Java 	/poets/satya-nand-java
Satyapal Anand 	/poets/satyapal-anand
Satyapal Janbaz 	/poets/satyapal-janbaz
Saud Usmani 	/poets/saud-usmani
Sauda Mohammad Rafi 	/poets/sauda-mohammad-rafi
Saulat Zaidi 	/poets/saulat-zaidi
Saurabh Shekhar 	/poets/saurabh-shekhar
Sawan Shukla 	/poets/sawan-shukla
Sayad Mohammad Abdul Ghafoor Shahbaz 	/poets/sayad-mohammad-abdul-ghafoor-shahbaz
Sayed Anjum Jafri 	/poets/sayed-anjum-jafri
Sayed Ayaz Mahmood 	/poets/sayed-ayaz-mahmood
Sayed Mehdi Hussain Mehdi 	/poets/sayed-mehdi-hussain-mehdi
Sayed Naseer Shah 	/poets/sayed-naseer-shah
Sayed Safi Hasan 	/poets/sayed-safi-hasan
Sayed Zia Alvi 	/poets/sayed-zia-alvi
Sayil Imran 	/poets/sayil-imran
Sayyad Ashoor Kazmi 	/poets/sayyad-ashoor-kazmi
Sayyad Ejaz Ahmad Rizwi 	/poets/sayyad-ejaz-ahmad-rizwi
Sayyad Nusrat Zaidi 	/poets/sayyad-nusrat-zaidi
Sayyad Sajid 	/poets/sayyad-sajid
Sayyad Zahiruddin Zaheer 	/poets/sayyad-zahiruddin-zaheer
Sayyada Arshia Haq 	/poets/sayyada-arshia-haq
SayyadTabish Alwari 	/poets/sayyadtabish-alwari
Seema Ghazal 	/poets/seema-ghazal
Seema Gupta 	/poets/seema-gupta
Seema Naqvi 	/poets/seema-naqvi
Seema Shakeb 	/poets/seema-shakeb
Seema Sharma Meeruthi 	/poets/seema-sharma-meeruthi
Seema Sharma Sarhad 	/poets/seema-sharma-sarhad
Seemab Akbarabadi 	/poets/seemab-akbarabadi
Seemab Batalvi 	/poets/seemab-batalvi
Seemab Sultanpuri 	/poets/seemab-sultanpuri-1
seemab zafar 	/poets/seemab-zafar
Seeman Naved 	/poets/seeman-naved
Seen Sheen Alam 	/poets/seen-sheen-alam
Sehr Ishqabadi 	/poets/sehr-ishqabadi
Shaad Aarfi 	/poets/shaad-aarfi
Shaad amritsarii 	/poets/shaad-amritsarii
Shaanul Haq Haqqi 	/poets/shaanul-haq-haqqi
Shaayar Lakhnavi 	/poets/shaayar-lakhnavi
Shabab 	/poets/shabab
Shabab Lalit 	/poets/shabab-lalit
Shabana Yousaf 	/poets/shabana-yousaf
Shabana zaidi shabeen 	/poets/shabana-zaidi-shabeen
Shabbir Naqid 	/poets/shabbir-naqid
Shabbir Nazish 	/poets/shabbir-nazish
Shabbir Shahid 	/poets/shabbir-shahid
Shabi Farooqui 	/poets/shabi-farooqui
Shabnam Ashai 	/poets/shabnam-ashai
Shabnam Munavari 	/poets/shabnam-munavari
Shabnam Naqvi 	/poets/shabnam-naqvi
Shabnam Rumani 	/poets/shabnam-rumani
Shabnam Shakeel 	/poets/shabnam-shakeel
Shabnam Waheed 	/poets/shabnam-waheed
Shad Azimabadi 	/poets/shad-azimabadi
Shad Bilgavi 	/poets/shad-bilgavi
Shad Lakhnavi 	/poets/shad-lakhnavi
Shad Nohi 	/poets/shad-nohi
Shadab Ulfat 	/poets/shadab-ulfat
Shadan Ahsan Marahravi 	/poets/shadan-ahsan-marahravi
Shadan Indauri 	/poets/shadan-indauri
Shaer Fatahpuri 	/poets/shaer-fatahpuri
Shafaq Imadpuri 	/poets/shafaq-imadpuri
Shafaq Sopori 	/poets/shafaq-sopori
Shafeeq Abbas 	/poets/shafeeq-abbas
Shafi Aqil 	/poets/shafi-aqil
Shafi Zamin 	/poets/shafi-zamin
Shafiq Aazmi 	/poets/shafiq-aazmi
Shafiq Ahmad 	/poets/shafiq-ahmad
Shafiq Asif 	/poets/shafiq-asif
Shafiq Dehlvi 	/poets/shafiq-dehlvi
Shafiq Fatima Shera 	/poets/shafiq-fatima-shera
Shafiq Jaunpuri 	/poets/shafiq-jaunpuri
Shafiq Khalish 	/poets/shafiq-khalish
Shafiq Rampuri 	/poets/shafiq-rampuri
Shafiq Saleemi 	/poets/shafiq-saleemi
Shafiullah Raz 	/poets/shafiullah-raz
Shafqat Batalvi 	/poets/shafqat-batalvi
Shafqat Kazmi 	/poets/shafqat-kazmi
Shafqat Sethi 	/poets/shafqat-sethi
Shafqat Tanveer Mirza 	/poets/shafqat-tanveer-mirza
Shaghil Qadri 	/poets/shaghil-qadri
Shagufta Altaf 	/poets/shagufta-altaf
Shagufta Talat Seema 	/poets/shagufta-talat-seema
Shagufta Yasmeen 	/poets/shagufta-yasmeen
Shah Aasim 	/poets/shah-aasim
Shah Deen  Humayun 	/poets/shah-deen-humayun
Shah Husain Nahri 	/poets/shah-husain-nahri
Shah Ji Ali 	/poets/shah-ji-ali
Shah Kamaluddin Kamal 	/poets/shah-kamaluddin-kamal
Shah Naseer 	/poets/shah-naseer
Shah Nawaz Zaidi 	/poets/shah-nawaz-zaidi
Shah Waqif 	/poets/shah-waqif
Shahab Akhtar 	/poets/shahab-akhtar
Shahab Ashraf 	/poets/shahab-ashraf
Shahab Jafri 	/poets/shahab-jafri
Shahab Safdar 	/poets/shahab-safdar
Shahab Sarmadi 	/poets/shahab-sarmadi
Shahabuddin Saqib 	/poets/shahabuddin-saqib
Shahana Shirin 	/poets/shahana-shirin
Shahbaz Khwaja 	/poets/shahbaz-khwaja
Shahbaz Nadeem Ziai 	/poets/shahbaz-nadeem-ziai
Shahbaz Rizwi 	/poets/shahbaz-rizwi
Shaheen Abbas 	/poets/shaheen-abbas
Shaheen Badr 	/poets/shaheen-badr
Shaheen Gazipuri 	/poets/shaheen-gazipuri
Shaheen Iqbal Asar 	/poets/shaheen-iqbal-asar
Shaheen Mufti 	/poets/shaheen-mufti
Shaheen Siddiqui 	/poets/shaheen-siddiqui
Shahid Ahmad Shoaib 	/poets/shahid-ahmad-shoaib
Shahid Akhtar 	/poets/shahid-akhtar
Shahid Aziz 	/poets/shahid-aziz
Shahid Bhopali 	/poets/shahid-bhopali
Shahid Fareed 	/poets/shahid-fareed
Shahid Ghazi 	/poets/shahid-ghazi
Shahid Ishqi 	/poets/shahid-ishqi
Shahid Jamal 	/poets/shahid-jamal
Shahid Jameel 	/poets/shahid-jameel
Shahid Kabir 	/poets/shahid-kabir
Shahid Kaleem 	/poets/shahid-kaleem
Shahid Kamal 	/poets/shahid-kamal
Shahid Latif 	/poets/shahid-latif
Shahid Mahuli 	/poets/shahid-mahuli
Shahid Malik 	/poets/shahid-malik
Shahid Meer 	/poets/shahid-meer
Shahid Naeem 	/poets/shahid-naeem
Shahid Shaidai 	/poets/shahid-shaidai
Shahid Zaki 	/poets/shahid-zaki
Shahida Hasan 	/poets/shahida-hasan
Shahida lateef 	/poets/shahida-lateef
Shahida Tabassum 	/poets/shahida-tabassum
Shahjahan Bano Yaad 	/poets/shahjahan-bano-yaad
Shahnawaz Zaidi 	/poets/shahnawaz-zaidi
Shahnaz Muzammil 	/poets/shahnaz-muzammil
Shahnaz Nabi 	/poets/shahnaz-nabi
Shahnaz Noor 	/poets/shahnaz-noor
Shahood Alam Aafaqi 	/poets/shahood-alam-aafaqi
Shahram Sarmadi 	/poets/shahram-sarmadi
Shahryar 	/poets/shahryar
Shahzad Ahmad 	/poets/shahzad-ahmad
Shahzad Anjum Burhani 	/poets/shahzad-anjum-burhani
Shahzad Hasan 	/poets/shahzad-hasan
Shahzad Husain Saail 	/poets/shahzad-husain-saail
Shahzad Nayar 	/poets/shahzad-nayar
Shahzad Qais 	/poets/shahzad-qais
Shahzad Qamar 	/poets/shahzad-qamar
Shaida Ambalvi 	/poets/shaida-ambalvi
Shaida Rumani 	/poets/shaida-rumani
Shaikh Abdul Lateef Tapish 	/poets/shaikh-abdul-lateef-tapish
Shaikh Meer Bakhsh Masroor 	/poets/shaikh-meer-bakhsh-masroor
Shaikh Mohammad Roshan Joshish Lakhnavi 	/poets/shaikh-mohammad-roshan-joshish-lakhnavi
Shaikh Zahuruddin Hatim 	/poets/shaikh-zahuruddin-hatim
Shaiq Muzaffarpuri 	/poets/shaiq-muzaffarpuri
Shaista Habeeb 	/poets/shaista-habeeb
Shaista Mufti 	/poets/shaista-mufti
Shaista Sahar 	/poets/shaista-sahar
Shaista Yusuf 	/poets/shaista-yusuf
Shakeb Ayaz 	/poets/shakeb-ayaz
Shakeb Banarsi 	/poets/shakeb-banarsi
Shakeb Jalali 	/poets/shakeb-jalali
Shakeel Azmi 	/poets/shakeel-azmi
Shakeel Badayuni 	/poets/shakeel-badayuni-3
Shakeel Gwaliari 	/poets/shakeel-gwaliari
Shakeel Jafri 	/poets/shakeel-jafri
Shakeel Jamali 	/poets/shakeel-jamali
Shakeel Jazib 	/poets/shakeel-jazib
Shakeel Mazhari 	/poets/shakeel-mazhari
Shakeel Nashtar 	/poets/shakeel-nashtar
Shakeel Sarosh 	/poets/shakeel-sarosh
Shakeel Shamsi 	/poets/shakeel-shamsi
Shakeela Bano 	/poets/shakeela-bano
Shakir Inayati 	/poets/shakir-inayati
Shakir Kalkattvi 	/poets/shakir-kalkattvi
Shakir Khaliq 	/poets/shakir-khaliq
Shakir Kundan 	/poets/shakir-kundan
Shakir Merathi 	/poets/shakir-merathi
Shakur Javed 	/poets/shakur-javed
Sham Rizvi 	/poets/sham-rizvi
Shamim Abbas 	/poets/shamim-abbas
Shamim Alvi 	/poets/shamim-alvi
Shamim Anwar 	/poets/shamim-anwar
Shamim Azar 	/poets/shamim-azar
Shamim Farooqui 	/poets/shamim-farooqui
Shamim Fatehpuri 	/poets/shamim-fatehpuri
Shamim Hanafi 	/poets/shamim-hanafi
Shamim Hashimi 	/poets/shamim-hashimi
Shamim Jaipuri 	/poets/shamim-jaipuri
Shamim Karhani 	/poets/shamim-karhani
Shamim Qasmi 	/poets/shamim-qasmi
Shamim Ravish 	/poets/shamim-ravish
Shamim Tariq 	/poets/shamim-tariq
Shams Fareedi 	/poets/shams-fareedi
Shams Farrukhabadi 	/poets/shams-farrukhabadi
Shams Itawi 	/poets/shams-itawi
Shams Ramzi 	/poets/shams-ramzi
Shams Tabrezi 	/poets/shams-tabrezi
Shams Zubairi 	/poets/shams-zubairi
Shamshad Shahar 	/poets/shamshad-shahar
Shamshir haidar 	/poets/shamshir-haidar
Shamsi Tasneem 	/poets/shamsi-tasneem
Shams-Un-Nisa Begum Sharm 	/poets/shams-un-nisa-begum-sharm
Shamsur Rahman Faruqi 	/poets/shamsur-rahman-faruqi
Shan Bharti 	/poets/shan-bharti
Shanawar Ishaq 	/poets/shanawar-ishaq
Shankar Lal Shankar 	/poets/shankar-lal-shankar
Shanti Lal Malhotra 	/poets/shanti-lal-malhotra
Sharaf Mujaddidi 	/poets/sharaf-mujaddidi
Sharar Fatehpuri 	/poets/sharar-fatehpuri
Shareef Ahmad Shareef 	/poets/shareef-ahmad-shareef
Shareef Munawwar 	/poets/shareef-munawwar
Sharib Lakhnavi 	/poets/sharib-lakhnavi
Sharib Mauranwi 	/poets/sharib-mauranwi
Sharif kunjahi 	/poets/sharif-kunjahi
Shariq Adeel 	/poets/shariq-adeel
Shariq Balyavi 	/poets/shariq-balyavi
Shariq Irayani 	/poets/shariq-irayani
Shariq Jamal 	/poets/shariq-jamal
Shariq Kaifi 	/poets/shariq-kaifi
sharmaa Taseer 	/poets/sharmaa-taseer
Sharvan Kumar Varma 	/poets/sharvan-kumar-varma
Shatir Amritsari 	/poets/shatir-amritsari
Shatir Hakeemi 	/poets/shatir-hakeemi
Shaukat Abidi 	/poets/shaukat-abidi
Shaukat Fahmi 	/poets/shaukat-fahmi
Shaukat Hashmi 	/poets/shaukat-hashmi
Shaukat Kazmi 	/poets/shaukat-kazmi
Shaukat Mehdi 	/poets/shaukat-mehdi
Shaukat Pardesi 	/poets/shaukat-pardesi
Shaukat Thanvi 	/poets/shaukat-thanvi
Shaukat Wasti 	/poets/shaukat-wasti
Shauq Bahraichi 	/poets/shauq-bahraichi
Shauq Bijnori 	/poets/shauq-bijnori
Shauq Dehlvi Makki 	/poets/shauq-dehlvi-makki
Shauq Jalandhari 	/poets/shauq-jalandhari
Shauq Mahri 	/poets/shauq-mahri
shauq Qidvai 	/poets/shauq-qidvai
Shauq Salki 	/poets/shauq-salki
Shayan  Quraishi 	/poets/shayan-quraishi
Shayar Ali Shayar 	/poets/shayar-ali-shayar
Shaz Tamkanat 	/poets/shaz-tamkanat
Shazia Naaz 	/poets/shazia-naaz
Shaziya Akbar 	/poets/shaziya-akbar
Sheen Kaaf Nizam 	/poets/sheen-kaaf-nizam-3
Sheerin Ahmad 	/poets/sheerin-ahmad
Sheesh Mohammad Ismail Azmi 	/poets/sheesh-mohammad-ismail-azmi
Shefta Mustafa Khan 	/poets/shefta-mustafa-khan
Shehpar Rasool 	/poets/shehpar-rasool
Shehzad Raza Lams 	/poets/shehzad-raza-lams
Sheikh Bimar Ali Bakhsh 	/poets/sheikh-bimar-ali-bakhsh
Sheikh Ibrahim Zauq 	/poets/sheikh-ibrahim-zauq
Sher Afzal Jafri 	/poets/sher-afzal-jafri
Sher Mohammad Khan Iman 	/poets/sher-mohammad-khan-iman
Sher Singh Naaz Dehlvi 	/poets/sher-singh-naaz-dehlvi
Sheri Bhopali 	/poets/sheri-bhopali
Shevan Bijnauri 	/poets/shevan-bijnauri
Shibli Nomani 	/poets/shibli-nomani
Shifa Kajgavnwi 	/poets/shifa-kajgavnwi
Shiv Charan Das Goyal Zabt 	/poets/shiv-charan-das-goyal-zabt
Shiv Dayal Sahab 	/poets/shiv-dayal-sahab
Shiv Ratan Lal Barq Punchhwi 	/poets/shiv-ratan-lal-barq-punchhwi
ShivKumar Bilgarami 	/poets/shivkumar-bilgarami
Shmashad shad 	/poets/shmashad-shad
Shoaib Ahmad Merathi Nudrat 	/poets/shoaib-ahmad-merathi-nudrat
Shoaib Bin Aziz 	/poets/shoaib-bin-aziz
Shoaib Nizam 	/poets/shoaib-nizam
Shobha Kukkal 	/poets/shobha-kukkal
Shohrat Bukhari 	/poets/shohrat-bukhari
Shoib Bukhari 	/poets/shoib-bukhari
Shola Aligarhi 	/poets/shola-aligarhi
Shola Haspanvi 	/poets/shola-haspanvi
Shola Kararvi 	/poets/shola-kararvi
Shoque Moradabadi 	/poets/shoque-moradabadi
Shorish kashmiri 	/poets/shorish-kashmiri
Shozeb Kashir 	/poets/shozeb-kashir
Shubh Taraz 	/poets/shubh-taraz
Shubha Shukla Mishra adhar 	/poets/shubha-shukla-mishra-adhar
Shuja 	/poets/shuja
Shuja Khaavar 	/poets/shuja-khaavar
Shujaat Ali Rahi 	/poets/shujaat-ali-rahi
Shujaat Iqbal 	/poets/shujaat-iqbal
Shumaila Bahzad 	/poets/shumaila-bahzad
Shuoor Balgirami 	/poets/shuoor-balgirami
Shyam Sundar Nanda Noor 	/poets/shyam-sundar-nanda-noor
Shyam Sunder Lal Barq 	/poets/shyam-sunder-lal-barq
Sibt Ahmad 	/poets/sibt-ahmad
Sibt Ali Saba 	/poets/sibt-ali-saba
Sibtain Akhgar 	/poets/sibtain-akhgar
Siddiq ahmad Nizami 	/poets/siddiq-ahmad-nizami
Siddiq Shahid 	/poets/siddiq-shahid
Siddiqa Shabnam 	/poets/siddiqa-shabnam
Siddique Afghani 	/poets/siddique-afghani
Siddique Kaleem 	/poets/siddique-kaleem
Siddique Mujibi 	/poets/siddique-mujibi
Siddique Umar 	/poets/siddique-umar
Sidra Sahar Imran 	/poets/sidra-sahar-imran
Sikandar Ali Wajd 	/poets/sikandar-ali-wajd
Sikandar Hayat Khayal 	/poets/sikandar-hayat-khayal
Siraj Ajmali 	/poets/siraj-ajmali
Siraj Alam Zakhmi 	/poets/siraj-alam-zakhmi
Siraj Aurangabadi 	/poets/siraj-aurangabadi
Siraj Faisal Khan 	/poets/siraj-faisal-khan
Siraj Lakhnavi 	/poets/siraj-lakhnavi
Siraj Muneer 	/poets/siraj-muneer
Sirajuddin Zafar 	/poets/sirajuddin-zafar
Siya sachdev 	/poets/siya-sachdev
Sohan Rahi 	/poets/sohan-rahi
Sonroopa Vishal 	/poets/sonroopa-vishal
Soz Barelvi 	/poets/soz-barelvi
Soz Najeebabadi 	/poets/soz-najeebabadi
Subhan Asad 	/poets/subhan-asad
Subhash Pathak Ziya 	/poets/subhash-pathak-ziya
Subodh Lal Saqi 	/poets/subodh-lal-saqi
Sudarshan Faakhir 	/poets/sudarshan-faakhir
Sudarshan Kumar Vuggal 	/poets/sudarshan-kumar-vuggal
Sudesh Kumar Mehr 	/poets/sudesh-kumar-mehr
Sudhanshu Firdaus 	/poets/sudhanshu-firdaus
Sudhir Bamola 	/poets/sudhir-bamola
Sufi Tabassum 	/poets/sufi-tabassum
Sufia Anjum Taj 	/poets/sufia-anjum-taj
Sughra Alam 	/poets/sughra-alam
Sughra Sabzwari 	/poets/sughra-sabzwari
Sughra Sadaf 	/poets/sughra-sadaf
Suha Mujaddadi 	/poets/suha-mujaddadi
Suhail Ahmad Khan 	/poets/suhail-ahmad-khan
Suhail Ahmed Zaidi 	/poets/suhail-ahmed-zaidi
Suhail Akhtar 	/poets/suhail-akhtar
Suhail Kakorvi 	/poets/suhail-kakorvi
Suhail Rashid 	/poets/suhail-rashid
Suhail Sani 	/poets/suhail-sani
Sulaiman Aasif 	/poets/sulaiman-aasif
sulaiman ahmad mani 	/poets/sulaiman-ahmad-mani
Sulaiman Areeb 	/poets/sulaiman-areeb
Sulaiman Jazib 	/poets/sulaiman-jazib
Sulaiman Khateeb 	/poets/sulaiman-khateeb
Suleman Khumar 	/poets/suleman-khumar
Sultan Akhtar 	/poets/sultan-akhtar
Sultan Ghauri 	/poets/sultan-ghauri
Sultan Nizami 	/poets/sultan-nizami
Sultan Rashk 	/poets/sultan-rashk
Sultan Sabr wani 	/poets/sultan-sabr-wani
Sultan Shahid 	/poets/sultan-shahid
Sultan Subhani 	/poets/sultan-subhani
Sultan Sukoon 	/poets/sultan-sukoon
Sultanul hasan Farooqi 	/poets/sultanul-hasan-farooqi
Suman Dhingra Duggal 	/poets/suman-dhingra-duggal
Sunil Aftab 	/poets/sunil-aftab
Sunil Kumar Jashn 	/poets/sunil-kumar-jashn
Suraiya Abbas 	/poets/suraiya-abbas
Suraj Narayan 	/poets/suraj-narayan
Suraj Narayan Meher 	/poets/suraj-narayan-meher
Suraj Tanveer 	/poets/suraj-tanveer
Surender Pandit Soz 	/poets/surender-pandit-soz
Surender Shajar 	/poets/surender-shajar
Suroor Ambalvi 	/poets/suroor-ambalvi
Suroor Barabankvi 	/poets/suroor-barabankvi
Suroor Jahanabadi 	/poets/suroor-jahanabadi
Suroor Kamran 	/poets/suroor-kamran
Suryabhanu Gupt 	/poets/suryabhanu-gupt
Swaleh Nadeem 	/poets/swaleh-nadeem
Swapnil Tiwari 	/poets/swapnil-tiwari
Syed Aabid Ali Aabid 	/poets/syed-aabid-ali-aabid
Syed Agha Ali Mehr 	/poets/syed-agha-ali-mehr
Syed Ahmed Shameem 	/poets/syed-ahmed-shameem
Syed Ahsan Javed 	/poets/syed-ahsan-javed
Syed Ameer Hasan Marharvi Diler 	/poets/syed-ameer-hasan-marharvi-diler
Syed Amin Ashraf 	/poets/syed-amin-ashraf
Syed Aminul Hasan Mohani Bismil 	/poets/syed-aminul-hasan-mohani-bismil
Syed Anwar Ahmad 	/poets/syed-anwar-ahmad
Syed Arif 	/poets/syed-arif
Syed Arif Ali 'Arif' 	/poets/syed-arif-ali-arif
Syed Bashir Husain Bashir 	/poets/syed-bashir-husain-bashir
Syed Basit Hussain Mahir Lakhnavi 	/poets/syed-basit-hussain-mahir-lakhnavi
Syed Faizi 	/poets/syed-faizi
Syed Farzand Ahmad Safeer 	/poets/syed-farzand-ahmad-safeer
Syed Fazlul Mateen 	/poets/syed-fazlul-mateen
Syed Habeeb 	/poets/syed-habeeb
Syed Hamid 	/poets/syed-hamid
Syed Iqbal Gilani 	/poets/syed-iqbal-gilani
Syed Iqbal Rizvi Sharib 	/poets/syed-iqbal-rizvi-sharib
Syed Jameel Madni 	/poets/syed-jameel-madni
Syed Kashif Raza 	/poets/syed-kashif-raza
Syed Kazim Ali Shaukat Bilgiraamii 	/poets/syed-kazim-ali-shaukat-bilgiraamii
Syed Mahmood Alam Rahbar 	/poets/syed-mahmood-alam-rahbar
Syed Manzoor Haidar 	/poets/syed-manzoor-haidar
Syed Mazhar Gilani 	/poets/syed-mazhar-gilani
Syed Mazhar Jameel 	/poets/syed-mazhar-jameel
Syed Meraj Jami 	/poets/syed-meraj-jami
Syed Mohammad Askari Arif 	/poets/syed-mohammad-askari-arif
Syed Mohammad Jafri 	/poets/syed-mohammad-jafri
Syed Mohammad Zafar, Ashk Sanbhali 	/poets/syed-mohammad-zafar-ashk-sanbhali
Syed Mubarak Shah 	/poets/syed-mubarak-shah
Syed Mubeen Alvi Khairabadi 	/poets/syed-mubeen-alvi-khairabadi
Syed Muneer 	/poets/syed-muneer
Syed Nawab Haider Naqvi Rahi 	/poets/syed-nawab-haider-naqvi-rahi
Syed Nazeer Hasan Sakha Dehlavi 	/poets/syed-nazeer-hasan-sakha-dehlavi
Syed Parvez 	/poets/syed-parvez
syed raza 	/poets/syed-raza
Syed Sadiq Ali Haseen 	/poets/syed-sadiq-ali-haseen
Syed Sagheer Safi 	/poets/syed-sagheer-safi
Syed Sajjad 	/poets/syed-sajjad
Syed Shafaq Shah Chishti 	/poets/syed-shafaq-shah-chishti
Syed Shakeel Desnavi 	/poets/syed-shakeel-desnavi
Syed Siddiq Hasan 	/poets/syed-siddiq-hasan
Syed Tamjeed Haider Tamjeed 	/poets/syed-tamjeed-haider-tamjeed
Syed Taslim Haider Qamar 	/poets/syed-taslim-haider-qamar
Syed Yusuf Ali Khan Nazim 	/poets/syed-yusuf-ali-khan-nazim
Syed Zameer Jafri 	/poets/syed-zameer-jafri
Syeda Kauzar Munawar Sharqpuri 	/poets/syeda-kauzar-munawar-sharqpuri
Syeda Nafis Bano shama 	/poets/syeda-nafis-bano-shama
Syeda Shan-e-Meraj 	/poets/syeda-shan-e-meraj
Syeda Ziya Khalida 	/poets/syeda-ziya-khalida
Taashshuq Lakhnavi 	/poets/taashshuq-lakhnavi
Tab Aslam 	/poets/tab-aslam
Taban Abdul Hai 	/poets/taban-abdul-hai
Taban Ghulam Rabbani 	/poets/taban-ghulam-rabbani
Tabassum Kashmiri 	/poets/tabassum-kashmiri
Tabassum Rizvi 	/poets/tabassum-rizvi
Tabish Dehlvi 	/poets/tabish-dehlvi
Tabish Kamal 	/poets/tabish-kamal
Tabish Kanpuri 	/poets/tabish-kanpuri
Tabish Mehdi 	/poets/tabish-mehdi
Tabish Siddiqui 	/poets/tabish-siddiqui
Tafazzul Husain Khan Kaukab Dehlavi 	/poets/tafazzul-husain-khan-kaukab-dehlavi
Tafzeel Ahmad 	/poets/tafzeel-ahmad
Tahir Adeem 	/poets/tahir-adeem
Tahir Azeem 	/poets/tahir-azeem
Tahir Faraz 	/poets/tahir-faraz
Tahir Tonsvi 	/poets/tahir-tonsvi
Tahira Jabeen Tara 	/poets/tahira-jabeen-tara
Tahseen Firaqi 	/poets/tahseen-firaqi
Tahzeeb Hafi 	/poets/tahzeeb-hafi
Taimur Hasan 	/poets/taimur-hasan
Taj Bhopali 	/poets/taj-bhopali
Taj Saeed 	/poets/taj-saeed
Tajammul Hussain Akhtar 	/poets/tajammul-hussain-akhtar
Tajdar Adil 	/poets/tajdar-adil
Tajvar Najibabadi 	/poets/tajvar-najibabadi
Takht Singh 	/poets/takht-singh
Talat Isharat 	/poets/talat-isharat
Taleef Haidar 	/poets/taleef-haidar
Talha Rizvi Barq 	/poets/talha-rizvi-barq
Talib Ali Khaan Aishi 	/poets/talib-ali-khaan-aishi
Talib Ansari 	/poets/talib-ansari
Talib Baghpati 	/poets/talib-baghpati
Talib Chakwali 	/poets/talib-chakwali
Talib Husain Talib 	/poets/talib-husain-talib
Talib Johari 	/poets/talib-johari
Tamanna Jamali 	/poets/tamanna-jamali
Tameezuddin Tameez Dehlvi 	/poets/tameezuddin-tameez-dehlvi
Tanha Timmapuri 	/poets/tanha-timmapuri
Tanveer Ahmad Alvi 	/poets/tanveer-ahmad-alvi
Tanveer Anjum 	/poets/tanveer-anjum
Tanveer Monis 	/poets/tanveer-monis
Tanveer Naqvi 	/poets/tanveer-naqvi
Tanveer Samani 	/poets/tanveer-samani
Tanveer Sipra 	/poets/tanveer-sipra
Tanvir Dehlvi 	/poets/tanvir-dehlvi
Tanweer Gauhar 	/poets/tanweer-gauhar
Taoos 	/poets/taoos
Tarannum Riyaz 	/poets/tarannum-riyaz
Tariq Badayuni 	/poets/tariq-badayuni
Taashshuq Lakhnavi 	/poets/taashshuq-lakhnavi
Tab Aslam 	/poets/tab-aslam
Taban Abdul Hai 	/poets/taban-abdul-hai
Taban Ghulam Rabbani 	/poets/taban-ghulam-rabbani
Tabassum Kashmiri 	/poets/tabassum-kashmiri
Tabassum Rizvi 	/poets/tabassum-rizvi
Tabish Dehlvi 	/poets/tabish-dehlvi
Tabish Kamal 	/poets/tabish-kamal
Tabish Kanpuri 	/poets/tabish-kanpuri
Tabish Mehdi 	/poets/tabish-mehdi
Tabish Siddiqui 	/poets/tabish-siddiqui
Tafazzul Husain Khan Kaukab Dehlavi 	/poets/tafazzul-husain-khan-kaukab-dehlavi
Tafzeel Ahmad 	/poets/tafzeel-ahmad
Tahir Adeem 	/poets/tahir-adeem
Tahir Azeem 	/poets/tahir-azeem
Tahir Faraz 	/poets/tahir-faraz
Tahir Tonsvi 	/poets/tahir-tonsvi
Tahira Jabeen Tara 	/poets/tahira-jabeen-tara
Tahseen Firaqi 	/poets/tahseen-firaqi
Tahzeeb Hafi 	/poets/tahzeeb-hafi
Taimur Hasan 	/poets/taimur-hasan
Taj Bhopali 	/poets/taj-bhopali
Taj Saeed 	/poets/taj-saeed
Tajammul Hussain Akhtar 	/poets/tajammul-hussain-akhtar
Tajdar Adil 	/poets/tajdar-adil
Tajvar Najibabadi 	/poets/tajvar-najibabadi
Takht Singh 	/poets/takht-singh
Talat Isharat 	/poets/talat-isharat
Taleef Haidar 	/poets/taleef-haidar
Talha Rizvi Barq 	/poets/talha-rizvi-barq
Talib Ali Khaan Aishi 	/poets/talib-ali-khaan-aishi
Talib Ansari 	/poets/talib-ansari
Talib Baghpati 	/poets/talib-baghpati
Talib Chakwali 	/poets/talib-chakwali
Talib Husain Talib 	/poets/talib-husain-talib
Talib Johari 	/poets/talib-johari
Tamanna Jamali 	/poets/tamanna-jamali
Tameezuddin Tameez Dehlvi 	/poets/tameezuddin-tameez-dehlvi
Tanha Timmapuri 	/poets/tanha-timmapuri
Tanveer Ahmad Alvi 	/poets/tanveer-ahmad-alvi
Tanveer Anjum 	/poets/tanveer-anjum
Tanveer Monis 	/poets/tanveer-monis
Tanveer Naqvi 	/poets/tanveer-naqvi
Tanveer Samani 	/poets/tanveer-samani
Tanveer Sipra 	/poets/tanveer-sipra
Tanvir Dehlvi 	/poets/tanvir-dehlvi
Tanweer Gauhar 	/poets/tanweer-gauhar
Taoos 	/poets/taoos
Tarannum Riyaz 	/poets/tarannum-riyaz
Tariq Badayuni 	/poets/tariq-badayuni
Tariq Butt 	/poets/tariq-butt
Tariq Hashmi 	/poets/tariq-hashmi
Tariq Jami 	/poets/tariq-jami
Tariq Masood 	/poets/tariq-masood
Tariq Matin 	/poets/tariq-matin
Tariq Naeem 	/poets/tariq-naeem
Tariq Pirzada 	/poets/tariq-pirzada
Tariq Qamar 	/poets/tariq-qamar
Tariq Rashid Darvesh 	/poets/tariq-rashid-darvesh
Tariq Shahid 	/poets/tariq-shahid
Tarkash Pradeep 	/poets/tarkash-pradeep
Taruna Mishra 	/poets/taruna-mishra
Tasadduq Husain Khalid 	/poets/tasadduq-husain-khalid
Tasawwur Zaidi 	/poets/tasawwur-zaidi
Taseer Siddiqui 	/poets/taseer-siddiqui
Tashi Zaheer 	/poets/tashi-zaheer
Taskeen Dehlavi 	/poets/taskeen-dehlavi
Tasleem Ahmad Tasavvur 	/poets/tasleem-ahmad-tasavvur
Tasleem Ilahi Zulfi 	/poets/tasleem-ilahi-zulfi
Tasneem Abidi 	/poets/tasneem-abidi
Tasneem Faruqi 	/poets/tasneem-faruqi
Taufeeq Sagar 	/poets/taufeeq-sagar
Tauqeer Abbas 	/poets/tauqeer-abbas
Tauqeer Ahmad 	/poets/tauqeer-ahmad
Tauqeer Raza 	/poets/tauqeer-raza
Tauqeer Taqi 	/poets/tauqeer-taqi
Tauseef Tabassum 	/poets/tauseef-tabassum
Tifl Dara 	/poets/tifl-dara
Tilak Raj Paras 	/poets/tilak-raj-paras
Tilok Chand Mahroom 	/poets/tilok-chand-mahroom
Tishna Barelvi 	/poets/tishna-barelvi
Tousief Tabish 	/poets/tousief-tabish
Tripurari 	/poets/tripurari
Tufail Ahmad Madni 	/poets/tufail-ahmad-madni
Tufail Bismil 	/poets/tufail-bismil
Tufail Chaturvedi 	/poets/tufail-chaturvedi
tufail Dara 	/poets/tufail-dara
Turfa Qureshi 	/poets/turfa-qureshi
Ufuq Lakhnavi 	/poets/ufuq-lakhnavi
Uma Shankar Chitravanshi Bazal 	/poets/uma-shankar-chitravanshi-bazal
Umair Manzar 	/poets/umair-manzar
Umair Najmi 	/poets/umair-najmi
Umang Bali 	/poets/umang-bali
Umar Ansari 	/poets/umar-ansari
Umar Farhat 	/poets/umar-farhat
Umar Farooq 	/poets/umar-farooq
Ummeed Fazli 	/poets/ummeed-fazli
Ummeed KHwaja 	/poets/ummeed-khwaja
Unwan Chishti 	/poets/unwan-chishti
Urfi Aafaqi 	/poets/urfi-aafaqi
Urmila Madhav 	/poets/urmila-madhav
Urooj Jafri 	/poets/urooj-jafri
Urooj Qadri 	/poets/urooj-qadri
Urooj Zaidi Badayuni 	/poets/urooj-zaidi-badayuni
Urooj Zehra Zaidi 	/poets/urooj-zehra-zaidi
Usha Bhadoriya 	/poets/usha-bhadoriya
Ufuq Lakhnavi 	/poets/ufuq-lakhnavi
Uma Shankar Chitravanshi Bazal 	/poets/uma-shankar-chitravanshi-bazal
Umair Manzar 	/poets/umair-manzar
Umair Najmi 	/poets/umair-najmi
Umang Bali 	/poets/umang-bali
Umar Ansari 	/poets/umar-ansari
Umar Farhat 	/poets/umar-farhat
Umar Farooq 	/poets/umar-farooq
Ummeed Fazli 	/poets/ummeed-fazli
Ummeed KHwaja 	/poets/ummeed-khwaja
Unwan Chishti 	/poets/unwan-chishti
Urfi Aafaqi 	/poets/urfi-aafaqi
Urmila Madhav 	/poets/urmila-madhav
Urooj Jafri 	/poets/urooj-jafri
Urooj Qadri 	/poets/urooj-qadri
Urooj Zaidi Badayuni 	/poets/urooj-zaidi-badayuni
Urooj Zehra Zaidi 	/poets/urooj-zehra-zaidi
Usha Bhadoriya 	/poets/usha-bhadoriya
Vafa Barahi 	/poets/vafa-barahi
Vafa Malikpuri 	/poets/vafa-malikpuri
Vahshi Kanpuri 	/poets/vahshi-kanpuri
Vali Madni 	/poets/vali-madni
Varis Kirmani 	/poets/varis-kirmani
Varsha Gorchhia 	/poets/varsha-gorchhia
Varun Anand 	/poets/varun-anand
Vasaf Basit 	/poets/vasaf-basit
Vijay Arun 	/poets/vijay-arun
Vijay Sharma Arsh 	/poets/vijay-sharma-arsh
Vikas Rana 	/poets/vikas-rana
Vikas Sharma Raaz 	/poets/vikas-sharma-raaz
Vilas Pandit Musafir 	/poets/vilas-pandit-musafir
Vineet Aashna 	/poets/vineet-aashna
Vinod Kumar Tripathi Bashar  new	/poets/vinod-kumar-tripathi-bashar
Vipul Kumar 	/poets/vipul-kumar
Vishal Khullar 	/poets/vishal-khullar
Vishma Khan Vishma 	/poets/vishma-khan-vishma
Vishvanath Dard 	/poets/vishvanath-dard
Vafa Barahi 	/poets/vafa-barahi
Vafa Malikpuri 	/poets/vafa-malikpuri
Vahshi Kanpuri 	/poets/vahshi-kanpuri
Vali Madni 	/poets/vali-madni
Varis Kirmani 	/poets/varis-kirmani
Varsha Gorchhia 	/poets/varsha-gorchhia
Varun Anand 	/poets/varun-anand
Vasaf Basit 	/poets/vasaf-basit
Vijay Arun 	/poets/vijay-arun
Vijay Sharma Arsh 	/poets/vijay-sharma-arsh
Vikas Rana 	/poets/vikas-rana
Vikas Sharma Raaz 	/poets/vikas-sharma-raaz
Vilas Pandit Musafir 	/poets/vilas-pandit-musafir
Vineet Aashna 	/poets/vineet-aashna
Vinod Kumar Tripathi Bashar  new	/poets/vinod-kumar-tripathi-bashar
Vipul Kumar 	/poets/vipul-kumar
Vishal Khullar 	/poets/vishal-khullar
Vishma Khan Vishma 	/poets/vishma-khan-vishma
Vishvanath Dard 	/poets/vishvanath-dard
Wafa Naqvi 	/poets/wafa-naqvi
Wafa Siddiqui 	/poets/wafa-siddiqui
Wahab Danish 	/poets/wahab-danish
Waheed Ahmad 	/poets/waheed-ahmad
Waheed Akhtar 	/poets/waheed-akhtar
Waheed Allahabadi 	/poets/waheed-allahabadi
Waheed Quraishi 	/poets/waheed-quraishi
Waheeda Naseem 	/poets/waheeda-naseem
Waheed-ul-Hasan Hashmi 	/poets/waheed-ul-hasan-hashmi
Wahid Premi 	/poets/wahid-premi
Wahiduddin Saleem 	/poets/wahiduddin-saleem
Wahshat Raza Ali Kalkatvi 	/poets/wahshat-raza-ali-kalkatvi
Waiza Rafeeq 	/poets/waiza-rafeeq
Wajd Chughtai 	/poets/wajd-chughtai
Wajeeh Sani 	/poets/wajeeh-sani
Wajid Ali Shah Akhtar 	/poets/wajid-ali-shah-akhtar
Wajid Ameer 	/poets/wajid-ameer
Wajid Qureshi 	/poets/wajid-qureshi
Wajid Sahri 	/poets/wajid-sahri
Wakil Akhtar 	/poets/wakil-akhtar
Wali Aasi 	/poets/wali-aasi
Wali Alam Shaheen 	/poets/wali-alam-shaheen
Wali Mohammad Wali 	/poets/wali-mohammad-wali
Wali Shamsi 	/poets/wali-shamsi
Wali Uzlat 	/poets/wali-uzlat
Waliullah Muhib 	/poets/waliullah-muhib
Waliullah Sarhindi Ishtiyaq 	/poets/waliullah-sarhindi-ishtiyaq
Waliullah wali 	/poets/waliullah-wali
Wamiq Jaunpuri 	/poets/wamiq-jaunpuri
Waqar Bijnori 	/poets/waqar-bijnori
Waqar Fatmi 	/poets/waqar-fatmi
Waqar Hilm Syed Naglavi 	/poets/waqar-hilm-syed-naglavi
Waqar Khan 	/poets/waqar-khan
Waqar Manvi 	/poets/waqar-manvi
Waqar Sahar 	/poets/waqar-sahar
Waqar Vasiqi 	/poets/waqar-vasiqi
Waqas Aziz 	/poets/waqas-aziz
Waqas Baloch 	/poets/waqas-baloch
Waqif rae Barelvi 	/poets/waqif-rae-barelvi
Waseem Akram 	/poets/waseem-akram
Waseem Barelvi 	/poets/waseem-barelvi
Waseem Khairabadi 	/poets/waseem-khairabadi
Waseem Malik 	/poets/waseem-malik
Waseem Minai 	/poets/waseem-minai
Waseem Tashif 	/poets/waseem-tashif
Wasi Shah 	/poets/wasi-shah
Wasif Dehlvi 	/poets/wasif-dehlvi
Wasif Yar 	/poets/wasif-yar
Wazir Agha 	/poets/wazir-agha
Wazir Ali Saba Lakhnavi 	/poets/wazir-ali-saba-lakhnavi
Wafa Naqvi 	/poets/wafa-naqvi
Wafa Siddiqui 	/poets/wafa-siddiqui
Wahab Danish 	/poets/wahab-danish
Waheed Ahmad 	/poets/waheed-ahmad
Waheed Akhtar 	/poets/waheed-akhtar
Waheed Allahabadi 	/poets/waheed-allahabadi
Waheed Quraishi 	/poets/waheed-quraishi
Waheeda Naseem 	/poets/waheeda-naseem
Waheed-ul-Hasan Hashmi 	/poets/waheed-ul-hasan-hashmi
Wahid Premi 	/poets/wahid-premi
Wahiduddin Saleem 	/poets/wahiduddin-saleem
Wahshat Raza Ali Kalkatvi 	/poets/wahshat-raza-ali-kalkatvi
Waiza Rafeeq 	/poets/waiza-rafeeq
Wajd Chughtai 	/poets/wajd-chughtai
Wajeeh Sani 	/poets/wajeeh-sani
Wajid Ali Shah Akhtar 	/poets/wajid-ali-shah-akhtar
Wajid Ameer 	/poets/wajid-ameer
Wajid Qureshi 	/poets/wajid-qureshi
Wajid Sahri 	/poets/wajid-sahri
Wakil Akhtar 	/poets/wakil-akhtar
Wali Aasi 	/poets/wali-aasi
Wali Alam Shaheen 	/poets/wali-alam-shaheen
Wali Mohammad Wali 	/poets/wali-mohammad-wali
Wali Shamsi 	/poets/wali-shamsi
Wali Uzlat 	/poets/wali-uzlat
Waliullah Muhib 	/poets/waliullah-muhib
Waliullah Sarhindi Ishtiyaq 	/poets/waliullah-sarhindi-ishtiyaq
Waliullah wali 	/poets/waliullah-wali
Wamiq Jaunpuri 	/poets/wamiq-jaunpuri
Waqar Bijnori 	/poets/waqar-bijnori
Waqar Fatmi 	/poets/waqar-fatmi
Waqar Hilm Syed Naglavi 	/poets/waqar-hilm-syed-naglavi
Waqar Khan 	/poets/waqar-khan
Waqar Manvi 	/poets/waqar-manvi
Waqar Sahar 	/poets/waqar-sahar
Waqar Vasiqi 	/poets/waqar-vasiqi
Waqas Aziz 	/poets/waqas-aziz
Waqas Baloch 	/poets/waqas-baloch
Waqif rae Barelvi 	/poets/waqif-rae-barelvi
Waseem Akram 	/poets/waseem-akram
Waseem Barelvi 	/poets/waseem-barelvi
Waseem Khairabadi 	/poets/waseem-khairabadi
Waseem Malik 	/poets/waseem-malik
Waseem Minai 	/poets/waseem-minai
Waseem Tashif 	/poets/waseem-tashif
Wasi Shah 	/poets/wasi-shah
Wasif Dehlvi 	/poets/wasif-dehlvi
Wasif Yar 	/poets/wasif-yar
Wazir Agha 	/poets/wazir-agha
Wazir Ali Saba Lakhnavi 	/poets/wazir-ali-saba-lakhnavi
Yagana Changezi 	/poets/yagana-changezi
Yahya Amjad 	/poets/yahya-amjad
Yahya Khalid 	/poets/yahya-khalid
Yahya Khan Yusuf Zai 	/poets/yahya-khan-yusuf-zai
Yameen 	/poets/yameen
Yaqeen Inamullah Khan 	/poets/yaqeen-inamullah-khan
Yaqoob Aamir 	/poets/yaqoob-aamir
Yaqoob Ali Aasi 	/poets/yaqoob-ali-aasi
Yaqoob Arif 	/poets/yaqoob-arif
Yaqoob Rahi 	/poets/yaqoob-rahi
Yaqoob Tasawwur 	/poets/yaqoob-tasawwur
Yaqoob Usmani 	/poets/yaqoob-usmani
Yaqoob Yawar 	/poets/yaqoob-yawar
Yaseen Afaqi 	/poets/yaseen-afaqi
Yaseen Afzal 	/poets/yaseen-afzal
Yaseen Qudrat 	/poets/yaseen-qudrat
Yaseen Zameer 	/poets/yaseen-zameer
Yashab Tamanna 	/poets/yashab-tamanna
Yashpal Gupta 	/poets/yashpal-gupta
Yasin Ali Khan Markaz 	/poets/yasin-ali-khan-markaz
Yasmeen Habeeb 	/poets/yasmeen-habeeb
Yasmeen Hameed 	/poets/yasmeen-hameed
Yawar Abbas 	/poets/yawar-abbas
Yawar Amaan 	/poets/yawar-amaan
Yazdani Jalandhari 	/poets/yazdani-jalandhari
Yogendra Bahal Tishna 	/poets/yogendra-bahal-tishna
Yunus Ghazi 	/poets/yunus-ghazi
Yusuf Azmi 	/poets/yusuf-azmi
Yusuf Hasan 	/poets/yusuf-hasan
Yusuf Jamal 	/poets/yusuf-jamal
Yusuf Kamran 	/poets/yusuf-kamran
Yusuf Khalid 	/poets/yusuf-khalid
Yusuf Rahat 	/poets/yusuf-rahat
Yusuf Taqi 	/poets/yusuf-taqi
Yusuf Zafar 	/poets/yusuf-zafar
Yagana Changezi 	/poets/yagana-changezi
Yahya Amjad 	/poets/yahya-amjad
Yahya Khalid 	/poets/yahya-khalid
Yahya Khan Yusuf Zai 	/poets/yahya-khan-yusuf-zai
Yameen 	/poets/yameen
Yaqeen Inamullah Khan 	/poets/yaqeen-inamullah-khan
Yaqoob Aamir 	/poets/yaqoob-aamir
Yaqoob Ali Aasi 	/poets/yaqoob-ali-aasi
Yaqoob Arif 	/poets/yaqoob-arif
Yaqoob Rahi 	/poets/yaqoob-rahi
Yaqoob Tasawwur 	/poets/yaqoob-tasawwur
Yaqoob Usmani 	/poets/yaqoob-usmani
Yaqoob Yawar 	/poets/yaqoob-yawar
Yaseen Afaqi 	/poets/yaseen-afaqi
Yaseen Afzal 	/poets/yaseen-afzal
Yaseen Qudrat 	/poets/yaseen-qudrat
Yaseen Zameer 	/poets/yaseen-zameer
Yashab Tamanna 	/poets/yashab-tamanna
Yashpal Gupta 	/poets/yashpal-gupta
Yasin Ali Khan Markaz 	/poets/yasin-ali-khan-markaz
Yasmeen Habeeb 	/poets/yasmeen-habeeb
Yasmeen Hameed 	/poets/yasmeen-hameed
Yawar Abbas 	/poets/yawar-abbas
Yawar Amaan 	/poets/yawar-amaan
Yazdani Jalandhari 	/poets/yazdani-jalandhari
Yogendra Bahal Tishna 	/poets/yogendra-bahal-tishna
Yunus Ghazi 	/poets/yunus-ghazi
Yusuf Azmi 	/poets/yusuf-azmi
Yusuf Hasan 	/poets/yusuf-hasan
Yusuf Jamal 	/poets/yusuf-jamal
Yusuf Kamran 	/poets/yusuf-kamran
Yusuf Khalid 	/poets/yusuf-khalid
Yusuf Rahat 	/poets/yusuf-rahat
Yusuf Taqi 	/poets/yusuf-taqi
Yusuf Zafar 	/poets/yusuf-zafar
Zaeem Rasheed 	/poets/zaeem-rasheed
Zafar Ahmad Parwaz 	/poets/zafar-ahmad-parwaz
Zafar Ajmi 	/poets/zafar-ajmi
Zafar Akbarabadi 	/poets/zafar-akbarabadi
Zafar Ali Khan 	/poets/zafar-ali-khan
Zafar Ansari Zafar 	/poets/zafar-ansari-zafar
Zafar Anwar 	/poets/zafar-anwar
Zafar Ghauri 	/poets/zafar-ghauri
Zafar Gorakhpuri 	/poets/zafar-gorakhpuri
Zafar Hameedi 	/poets/zafar-hameedi
Zafar Imam 	/poets/zafar-imam
Zafar Iqbal 	/poets/zafar-iqbal
zafar iqbal zafar 	/poets/zafar-iqbal-zafar
Zafar Kaleem 	/poets/zafar-kaleem
Zafar Kamali 	/poets/zafar-kamali
Zafar Khan Niyazi 	/poets/zafar-khan-niyazi
Zafar Moradabadi 	/poets/zafar-moradabadi
Zafar Rabab 	/poets/zafar-rabab
Zafar Sahbai 	/poets/zafar-sahbai
Zafar Siddiqui 	/poets/zafar-siddiqui
Zafar Taban 	/poets/zafar-taban
Zafar Tabish 	/poets/zafar-tabish
Zafar Zaidi 	/poets/zafar-zaidi
Zafarul Hasnain Zafar 	/poets/zafarul-hasnain-zafar
Zaheer Ahmad Zaheer 	/poets/zaheer-ahmad-zaheer
Zaheer Dehlvi 	/poets/zaheer-dehlvi
Zaheer Fatehpuri 	/poets/zaheer-fatehpuri
Zaheer Ghazipuri 	/poets/zaheer-ghazipuri
Zaheer Kashmiri 	/poets/zaheer-kashmiri
Zaheer Rahmati 	/poets/zaheer-rahmati
Zaheer Siddiqui 	/poets/zaheer-siddiqui
Zahid Afaq 	/poets/zahid-afaq
Zahid Chaudhry 	/poets/zahid-chaudhry
Zahid Dar 	/poets/zahid-dar
Zahid Fakhri 	/poets/zahid-fakhri
Zahid Farani 	/poets/zahid-farani
Zahid Hasan 	/poets/zahid-hasan
Zahid Hasan Chugtai 	/poets/zahid-hasan-chugtai
Zahid Imroz 	/poets/zahid-imroz
Zahid Kamal 	/poets/zahid-kamal
Zahid Masood 	/poets/zahid-masood
zahid Muneer Amir 	/poets/zahid-muneer-amir
Zahid Naved 	/poets/zahid-naved
Zahid Shamsi 	/poets/zahid-shamsi
Zahida Hina 	/poets/zahida-hina-3
Zahida Kamal 	/poets/zahida-kamal
Zahida Zaidi 	/poets/zahida-zaidi
Zahidul Haque 	/poets/zahidul-haque
Zahiir Ahmad Taaj 	/poets/zahiir-ahmad-taaj
zahraa Qarar 	/poets/zahraa-qarar
Zaeem Rasheed 	/poets/zaeem-rasheed
Zafar Ahmad Parwaz 	/poets/zafar-ahmad-parwaz
Zafar Ajmi 	/poets/zafar-ajmi
Zafar Akbarabadi 	/poets/zafar-akbarabadi
Zafar Ali Khan 	/poets/zafar-ali-khan
Zafar Ansari Zafar 	/poets/zafar-ansari-zafar
Zafar Anwar 	/poets/zafar-anwar
Zafar Ghauri 	/poets/zafar-ghauri
Zafar Gorakhpuri 	/poets/zafar-gorakhpuri
Zafar Hameedi 	/poets/zafar-hameedi
Zafar Imam 	/poets/zafar-imam
Zafar Iqbal 	/poets/zafar-iqbal
zafar iqbal zafar 	/poets/zafar-iqbal-zafar
Zafar Kaleem 	/poets/zafar-kaleem
Zafar Kamali 	/poets/zafar-kamali
Zafar Khan Niyazi 	/poets/zafar-khan-niyazi
Zafar Moradabadi 	/poets/zafar-moradabadi
Zafar Rabab 	/poets/zafar-rabab
Zafar Sahbai 	/poets/zafar-sahbai
Zafar Siddiqui 	/poets/zafar-siddiqui
Zafar Taban 	/poets/zafar-taban
Zafar Tabish 	/poets/zafar-tabish
Zafar Zaidi 	/poets/zafar-zaidi
Zafarul Hasnain Zafar 	/poets/zafarul-hasnain-zafar
Zaheer Ahmad Zaheer 	/poets/zaheer-ahmad-zaheer
Zaheer Dehlvi 	/poets/zaheer-dehlvi
Zaheer Fatehpuri 	/poets/zaheer-fatehpuri
Zaheer Ghazipuri 	/poets/zaheer-ghazipuri
Zaheer Kashmiri 	/poets/zaheer-kashmiri
Zaheer Rahmati 	/poets/zaheer-rahmati
Zaheer Siddiqui 	/poets/zaheer-siddiqui
Zahid Afaq 	/poets/zahid-afaq
Zahid Chaudhry 	/poets/zahid-chaudhry
Zahid Dar 	/poets/zahid-dar
Zahid Fakhri 	/poets/zahid-fakhri
Zahid Farani 	/poets/zahid-farani
Zahid Hasan 	/poets/zahid-hasan
Zahid Hasan Chugtai 	/poets/zahid-hasan-chugtai
Zahid Imroz 	/poets/zahid-imroz
Zahid Kamal 	/poets/zahid-kamal
Zahid Masood 	/poets/zahid-masood
zahid Muneer Amir 	/poets/zahid-muneer-amir
Zahid Naved 	/poets/zahid-naved
Zahid Shamsi 	/poets/zahid-shamsi
Zahida Hina 	/poets/zahida-hina-3
Zahida Kamal 	/poets/zahida-kamal
Zahida Zaidi 	/poets/zahida-zaidi
Zahidul Haque 	/poets/zahidul-haque
Zahiir Ahmad Taaj 	/poets/zahiir-ahmad-taaj
zahraa Qarar 	/poets/zahraa-qarar
Zahurullah Badayuni Nava 	/poets/zahurullah-badayuni-nava
Zaib Usmania 	/poets/zaib-usmania
Zaid Imbisat 	/poets/zaid-imbisat
Zaigham Hameedi 	/poets/zaigham-hameedi
Zain Ramish 	/poets/zain-ramish
Zainab Begum Ibrat 	/poets/zainab-begum-ibrat
Zain-ul-Abideen Khan Arif 	/poets/zain-ul-abideen-khan-arif
Zaka Siddiqui 	/poets/zaka-siddiqui
Zakariya Shaz 	/poets/zakariya-shaz
Zakauddin Shaya.n 	/poets/zakauddin-shayan
Zakhmi Hisari 	/poets/zakhmi-hisari
Zaki kakorvi 	/poets/zaki-kakorvi
Zaki Tariq 	/poets/zaki-tariq
Zakia Ghazal 	/poets/zakia-ghazal
Zakir Khan Zakir 	/poets/zakir-khan-zakir
Zaman Kanjahi 	/poets/zaman-kanjahi
Zaman Malik 	/poets/zaman-malik
Zameer Atraulvi 	/poets/zameer-atraulvi
Zameer Azhar 	/poets/zameer-azhar
Zameer Kazmi 	/poets/zameer-kazmi
Zareef Lakhnavi 	/poets/zareef-lakhnavi
Zareena Sani 	/poets/zareena-sani
Zauqi Muzaffar Nagari 	/poets/zauqi-muzaffar-nagari
Ze Khe Sheen 	/poets/ze-khe-sheen
Zeb Bareilwi 	/poets/zeb-bareilwi
Zeb Ghauri 	/poets/zeb-ghauri
Zeba 	/poets/zeba
Zebunnisaa Zaibii 	/poets/zebunnisaa-zaibii
Zeef Zia 	/poets/zeef-zia
Zeeshaan sajid 	/poets/zeeshaan-sajid
Zeeshan Athar 	/poets/zeeshan-athar
Zeeshan Haider 	/poets/zeeshan-haider
Zeeshan Ilahi 	/poets/zeeshan-ilahi
Zeeshan Mehdi 	/poets/zeeshan-mehdi
Zeeshan Sahil 	/poets/zeeshan-sahil-1
Zehra Alvi 	/poets/zehra-alvi
Zehra Nigaah 	/poets/zehra-nigaah
Zia Faruqi 	/poets/zia-faruqi
Zia Fatehabadi 	/poets/zia-fatehabadi
Zia Jalandhari 	/poets/zia-jalandhari
Zia Zameer 	/poets/zia-zameer
Ziauddin Ahmad Shakeb 	/poets/ziauddin-ahmad-shakeb
Zia-ul-Haq Qasmi 	/poets/zia-ul-haq-qasmi
Zia-ul-Mustafa Turk 	/poets/zia-ul-mustafa-turk
Ziaur Rahman Azmi 	/poets/ziaur-rahman-azmi
Ziya Mazkoor 	/poets/ziya-mazkoor
Ziya Shabnami 	/poets/ziya-shabnami
Ziyaul Hasan 	/poets/ziyaul-hasan
Zohra Naseem 	/poets/zohra-naseem
Zubair Ali Tabish 	/poets/zubair-ali-tabish
Zubair Amrohvi 	/poets/zubair-amrohvi
Zubair Farooq 	/poets/zubair-farooq
Zubair Qaisar 	/poets/zubair-qaisar
Zubair Rizvi 	/poets/zubair-rizvi
Zubair Shifai 	/poets/zubair-shifai
Zuhair Kanjahi 	/poets/zuhair-kanjahi
Zuhoor Nazar 	/poets/zuhoor-nazar
Zuhoor-ul-Islam Javed 	/poets/zuhoor-ul-islam-javed
Zulfeqar Ahmad 	/poets/zulfeqar-ahmad
Zulfiqar Aadil 	/poets/zulfiqar-aadil
Zulfiqar Ahmad Tabish 	/poets/zulfiqar-ahmad-tabish
Zulfiqar Ahsan 	/poets/zulfiqar-ahsan
Zulfiqar Ali Bukhari 	/poets/zulfiqar-ali-bukhari
Zulfiqar Naqvi 	/poets/zulfiqar-naqvi
